NNNNNNNNNNNNNNNNNNNNNNNNNNNNNNNNNNNNNNNNNNNNNNNNNNNNNNNNNNNNNNNNNNNNNNNNNNNYYNNNNNNNNNNNNNNNNNNYYNNYYNNNNNNNNNNNNNNNNNNNNNNNNNNNNNNNNNNYYNNNNNNNNNNNNNNNNNNYYNNNNN
NNNNNNNNNNNNNNNNNNNNNNNYYNNNNNNNNNNNNNNNNNNNNNNNNNNNNNNYYNNNNNNYYNNNNNNNNNNNNNNNNNNYYNNNNNNNNNNNNNNNNNNNNNNNNNNYYNNNNNNNNNNNNNNNNNNNNNNNNNNNNNNNNNNNNNNNNNNNNNNYYN
NNNNNNNNNNNYYNNNNNNNNNNNNNNYYNNYYNNYYNNNNNNNNNNYYNNNNNNNNNNNNNNNNNNNNNNNNNNNNNNNNNNNNNNNNNNNNNNNNNNNNNNYYNNYYNNNNNNNNNNNNNNYYNNNNNNNNNNNNNNYYNNNNNNYYNNNNNNNNNNNNN
NNNYYNNNNNNNNNNNNNNNNNNNNNNNNNNNNNNNNNNNNNNYYNNNNNNNNNNNNNNYYNNNNNNYYNNNNNNNNNNYYNNNNNNNNNNYYNNNNNNNNNNNNNNNNNNNNNNYYNNYYNNNNNNYYNNYYNNNNNNNNNNNNNNNNNNNNNNNNNNNNN
NNNNNNNYYNNNNNNYYNNYYNNNNNNNNNNNNNNNNNNYYNNNNNNNNNNYYNNNNNNNNNNNNNNNNNNYYNNNNNNNNNNNNNNYYNNNNNNNNNNNNNNNNNNNNNNNNNNNNNNNNNNNNNNNNNNNNNNNNNNNNNNYYNNNNNNYYNNNNNNNNN
------------------------------------------------------------------------------------------------------------------------------------------------------------------
------------------------------------------------------------------------------------------------------------------------------------------------------------------
------------------------------------------------------------------------------------------------------------------------------------------------------------------
------------------------------------------------------------------------------------------------------------------------------------------------------------------
------------------------------------------------------------------------------------------------------------------------------------------------------------------
-----------------------------------------------------------------------------------------------------------E------------------------------------------------------
---------------------------EE--------------------------oo--------------------------oo----------E------------E--oo-----------E-------------------------------------
-----------EE------S------------------------------------------------XX-----?Q-----------------X?Q--------------------------------------------------E------------o-
-----------------------oo------------------------------------------X]------------------------------------------------------E-----------------------------------o--
---------------------------------------------------------------oo--[]----------<>----------E-------------------------------------------------------------------o--
-------------------------------E-----------B------------------xx---[]----------[]----------<>--------------------------------------------------------------QQ-----
--------------------------------E-------B-------EX-----------xx-x--[]xxx---QQ--[]----------[]--SQ--QQ--EE--------------<>------<>-------?-----------E-------------
---------------B-------------------EE--Bb------E------------xx---x-<xx--xx-----XX----------[]--------------------------[]------[]---------------------------------
-------BB------bB-xxxx-----------------bB----------B-xxxxxxxx-----xxxX-<>-x------------BB--[]----------------------<>--[]------[]--<>--?--------B-------B-xxxxxxxx
-xxxxxxxxxxxxxxxxxxBB-xxxxxxxxxxxxxxxxxxxxxxxxxxxxxxx------<>-----XxXX-[]--xxxxxxxxxxxxxxxx[]-----X----------------[]-XXX------[]--[]------EE--Bb------BxxxXXXXXXX
XXX<>XXXXXXXXXXXXXXXXXXXXXXXXXXXXXXXXXXXXXXX<>XXXXXXx----X-[]-----XXXXXXXXXXXXXXXXXXXXXXXXXXXXXXXXXXXXXXXXXXXXXXX--XXXXXX-----XXXXXXXXX-XXXXXXXXXXXXXXXXXXXXXXXXXX
