NNNNNNNNNNNNNNNNNNN
NNNNNNNNNNNNNNNNNNN
NNNNNYYNNYYNNYYNNYY
NNNYYNNYYNNYYNNYYNN
NNNNNNNNNNNNNNNNNNN
-------------------
-------------------
-------------------
-------------------
-------------------
-------------------
-------------------
-------------------
-------------------
-------------------
---<E--------------
---[>-EE--E<-Eo----
---X----<----------
-------------------
-xxxxxxxxxxxxxxxxxx
XXXXXXXXXXXXXXXE<>E
