NNNNNNNNNNNNNNNNNNN
NNNNNNNNNNNNNNNNNNN
NNNNNYYNNYYNNYYNNYY
NNNYYNNYYNNYYNNYYNN
NNNNNNNNNNNNNNNNNNN
-------------------
-------------------
-------------------
-------------------
-------------------
-------------------
-------------------
-------------------
-------------------
-------------------
----------E--------
---<-----E---EE---o
-----EE----<-----E-
-----------E-------
-xxxxxxxxxxxxxxxxxx
XXXXXXX<>XXXXXX<>XX
