NNNNNNNNNNNNNNNNNNN
NNNNNNNNNNNNNNNNNNN
NNNNNYYNNYYNNYYNNYY
NNNYYNNYYNNYYNNYYNN
NNNNNNNNNNNNNNNNNNN
-------------------
-------------------
-------------------
-------------------
-------------------
-------------------
-------------------
-------------------
-------<E----------
-------[>----------
-------[]----------
---<--EXXE--------E
----------E--------
-----------------E-
-xxxxxxxxxxxxxxxxxx
XXXXXEXXXXX<>EE<>XX
