NNNNNNNNNNNNNNNNNNN
NNNNNNNNNNNNNNNNNNN
NNNNNYYNNYYNNYYNNYY
NNNYYNNYYNNYYNNYYNN
NNNNNNNNNNNNNNNNNNN
-------------------
-------------------
-------------------
-------------------
-------------------
-------------------
-------------------
-------------------
-------------------
------------------x
-----------------xx
------E-------o-xx-
-----E-------E-xx>-
-------E------xx<]-
-xxxxxxxxxxxxxx-[]E
XXX<>XXX<>E<>XXEXXX
