NNNNNNNNNNNNNNNNNNN
NNNNNNNNNNNNNNNNNNN
NNNNNYYNNYYNNYYNNYY
NNNYYNNYYNNYYNNYYNN
NNNNNNNNNNNNNNNNNNN
-------------------
-------------------
-------------------
-------------------
-------------------
-------------------
-------------------
-------------------
-------------------
-------------------
-------------------
------xxxx----xxxx-
---B-xx<>-x--xx<>-x
----xx-[]--xxx-[]--
-xxxx--[]EE<>EEXXEE
XXXXEEEXXXX[]XXXXXX
