NNNNNNNNNNNNNNNNNNN
NNNNNNNNNNNNNNNNNNN
NNNNNYYNNYYNNYYNNYY
NNNYYNNYYNNYYNNYYNN
NNNNNNNNNNNNNNNNNNN
-------------------
-------------------
-------------------
-------------------
-------------------
-------------------
-------------------
-------------------
-------------------
-------------------
---<-------->------
---[>------<]------
---[]--<>--[]------
---X]--[]--[]--<>--
-xx[]EE[]-E[]EE[]EE
XXXXXXXXXXXXXXXXXXX
