NNNNNNNNNNNNNNNNNNN
NNNNNNNNNNNNNNNNNNN
NNNNNYYNNYYNNYYNNYY
NNNYYNNYYNNYYNNYYNN
NNNNNNNNNNNNNNNNNNN
-------------------
-------------------
-------------------
-------------------
-------------------
-------------------
-------------------
-------------------
-------------------
-------------------
-------------------
------E---EE-------
-----E-----E--xxxx-
---<---EEE---xx<>-x
-xxxxxxxxxxxxx-[]EE
XXXXXXXXXXXXXEEXXXX
