NNNNNNNNNNNNNNNNNNN
NNNNNNNNNNNNNNNNNNN
NNNNNYYNNYYNNYYNNYY
NNNYYNNYYNNYYNNYYNN
NNNNNNNNNNNNNNNNNNN
-------------------
-------------------
-------------------
-------------------
-------------------
-------------------
-------------------
-------------------
---<>--------------
---[]--------------
---X]--------------
----------xxxx--xxx
------E--xx<>-xxx--
-----Exxxx-[]--<>--
-xxxxxx<>EEXXE-[]EE
XXXXXXX[]XXXXXEXXXX
