NNNNNNNNNNNNNNNNNNN
NNNNNNNNNNNNNNNNNNN
NNNNNYYNNYYNNYYNNYY
NNNYYNNYYNNYYNNYYNN
NNNNNNNNNNNNNNNNNNN
-------------------
-------------------
-------------------
-------------------
-------------------
-------------------
-------------------
-------------------
------------------E
------------------X
---<----------E--E-
---[>-o------E-----
---X-E-EEEE--------
-------------------
-xxxxxxxxxxxxxxxxxx
XXXXXXXXXXX<>XX<>XX
