NNNNNNNNNNNNNNNNNNN
NNNNNYYNNYYNNYYNNYY
NNNNNNNNNNNNNNNNNNN
NNNNNNNNNNNNNNNNNNN
NNNYYNNYYNNYYNNYYNN
-------------------
-------------------
-------------------
-------------------
-------------------
-------------------
-------------------
-------------------
------------------o
-----------------o-
-----oo---o--oo----
-----S---o---------
---B---B-----------
---bB--bB----------
-xxxxxxxxxxxxxxxxxx
XXXXXXXXXXX<>XX<>XX
