NNNNNNNNNNNNNNNNNNN
NNNNNYYNNYYNNYYNNYY
NNNNNNNNNNNNNNNNNNN
NNNNNNNNNNNNNNNNNNN
NNNYYNNYYNNYYNNYYNN
-------------------
-------------------
-------------------
-------------------
-------------------
-------------------
-------------------
-------------------
-------------------
-----------------oo
-----oo--oo--oo----
-------------------
---B-------------xx
---bB----------xx--
-xxxxxxxxxxxxxxx>--
XXXXXXX<>XX<>XX<]--
