NNNNNNNNNNNNNNNNNNN
NNNNNYYNNYYNNYYNNYY
NNNNNNNNNNNNNNNNNNN
NNNNNNNNNNNNNNNNNNN
NNNYYNNYYNNYYNNYYNN
-------------------
-------------------
-------------------
-------------------
-------------------
-------------------
-------------------
------------------o
------------------x
-------------xxxxxx
------o----xxx---x-
-----o----xx<>--<>-
---B-----xx-[]--[]-
---bB-xxxx--[]--[]-
-xxxxxx-<>--[]oE[]-
XXXXXXX-[]o-XXXXXX-
