NNNNNNNNNNNNNNNNNNN
NNNNNYYNNYYNNYYNNYY
NNNNNNNNNNNNNNNNNNN
NNNNNNNNNNNNNNNNNNN
NNNYYNNYYNNYYNNYYNN
-------------------
-------------------
-------------------
-------------------
-------------------
-------------------
-------------------
-------------------
-----------------oo
-------------------
------o---o--oo----
-----o---o---------
-------B-----------
---BB--bB------xxxx
-xxxxxxxxxxxxxxx>--
XXXXXXXXXXX<>XX<]--
