NNNNNNNNNNNNNNNNNNN
NNNNNYYNNYYNNYYNNYY
NNNNNNNNNNNNNNNNNNN
NNNNNNNNNNNNNNNNNNN
NNNYYNNYYNNYYNNYYNN
-------------------
-------------------
-------------------
-------------------
-------------------
-------------------
-------------------
-----------------oo
-------------------
-------------oo----
---------Qo-------x
-----oo----------xx
---BB--------xxxxx-
---bb--xxx-xx---x--
-xxxxxxx<-xx>--EX--
XXXXXXXE[>X<]------
