NNNNNNNNNNNNNNNNNNN
NNNNNYYNNYYNNYYNNYY
NNNNNNNNNNNNNNNNNNN
NNNNNNNNNNNNNNNNNNN
NNNYYNNYYNNYYNNYYNN
-------------------
-------------------
-------------------
-------------------
-------------------
-------------------
-----------------oo
-----------------SS
-------------------
----------o--------
-----oo--o---oo----
---------S----S----
---------------<---
---BB--BB--BB--b---
-xxxxxxxxxxxxxxxxxx
XXXXXXXXXXXXXXXXXXX
