NNNNNNNNNNNNNNNNNNN
NNNNNYYNNYYNNYYNNYY
NNNNNNNNNNNNNNNNNNN
NNNNNNNNNNNNNNNNNNN
NNNYYNNYYNNYYNNYYNN
-------------------
-------------------
-------------------
-------------------
-------------------
-------------------
-------------------
-------------------
-------------------
-----------------oo
-----oo--oo--oo---x
-----------------xx
----------------xx-
---BB--BB-----xxx--
-xxxxxxxxxxxxxx<>--
XXXXXXXXXXX<>XX[]--
