NNNNNNNNNNNNNNNNNNN
NNNNNYYNNYYNNYYNNYY
NNNNNNNNNNNNNNNNNNN
NNNNNNNNNNNNNNNNNNN
NNNYYNNYYNNYYNNYYNN
-------------------
-------------------
-------------------
-------------------
-------------------
-------------------
-------------oo----
----------o-SSS----
----------XS-------
-------------------
------o--E-------oo
-----o-------------
---B-------E-------
---bB--BB---B--BB--
-xxxxxxxxxxxxxxxxxx
XXXXXXXXXXXXXXXXXXX
