NNNNNNNNNNNNNNNNNNN
NNNNNYYNNYYNNYYNNYY
NNNNNNNNNNNNNNNNNNN
NNNNNNNNNNNNNNNNNNN
NNNYYNNYYNNYYNNYYNN
-------------------
-------------------
-------------------
-------------------
-------------------
-------------------
-------------------
-------------------
-------------------
--------------o----
------o--oo--------
-----o-----xxxx--?o
---B------xx<>-x---
---bB--BBxx-[]--xxx
-xxxxxxxxx-E[]--<--
XXXXXXXXXX-XXXX-[--
