NNNNNNNNNNNNNNNNNNN
NNNNNYYNNYYNNYYNNYY
NNNNNNNNNNNNNNNNNNN
NNNNNNNNNNNNNNNNNNN
NNNYYNNYYNNYYNNYYNN
-------------------
-------------------
-------------------
-------------------
-------------------
-------------------
-------------------
-------------------
-------------------
----------o--------
------o--o-------?o
-----o-----xxxx---x
----------xx<>-x-xx
---BB--BBxx-[]--xx-
-xxxxxxxxx-E[]o-<X-
XXXXXXXXXX-XXXX-[X-
