NNNNNNNNNNNNNNNNNNNYYNNNNNNNNNNNNNNNNNNNNNNNNNNNNNNNNNNNNNNNNNNNNNNNNNNNNNNNNNNNNNNYYNNNNNNNNNNNNNNNNNNNNNNNNNNNNNNNNNNNNNNYYNNYYNNYYNNYYNNNNNNYYNNNNNNNNNNYYNNNNN
NNNYYNNNNNNNNNNNNNNNNNNNNNNNNNNNNNNNNNNNNNNNNNNNNNNNNNNNNNNNNNNNNNNNNNNYYNNYYNNNNNNNNNNNNNNNNNNNNNNNNNNNNNNNNNNNNNNYYNNNNNNNNNNNNNNNNNNNNNNNNNNNNNNNNNNNNNNNNNNNNN
NNNNNNNNNNNNNNNYYNNNNNNNNNNNNNNNNNNNNNNNNNNYYNNNNNNNNNNNNNNYYNNYYNNNNNNNNNNNNNNNNNNNNNNNNNNNNNNNNNNNNNNNNNNNNNNYYNNNNNNNNNNNNNNNNNNNNNNNNNNYYNNNNNNNNNNNNNNNNNNYYN
NNNNNNNYYNNNNNNNNNNNNNNYYNNNNNNYYNNNNNNNNNNNNNNNNNNYYNNNNNNNNNNNNNNYYNNNNNNNNNNNNNNNNNNNNNNYYNNYYNNYYNNYYNNYYNNNNNNNNNNYYNNNNNNNNNNNNNNNNNNNNNNNNNNYYNNNNNNNNNNNNN
NNNNNNNNNNNYYNNNNNNNNNNNNNNYYNNNNNNYYNNYYNNNNNNYYNNNNNNYYNNNNNNNNNNNNNNNNNNNNNNYYNNNNNNYYNNNNNNNNNNNNNNNNNNNNNNNNNNNNNNNNNNNNNNNNNNNNNNNNNNNNNNNNNNNNNNYYNNNNNNNNN
------------------------------------------------------------------------------------------------------------------------------------------------------------------
------------------------------------------------------------------------------------------------------------------------------------------------------------------
------------------------------------------------------------------------------------------------------------------------------------------------------------------
------------------------------------------------------------------------------------------------------------------------------------------------------------------
------------------------------------------------------------------------------------------------------------------------------------------------------------------
---------------------------------------------------------------EX-------------------------------------------------------------------------------------------------
---------------------------------------------------------------X[------o---oo--------------------------------------oo------------------------------------------SSS
-------------------QQ-----------------------------------------XX[-------------------------------------------------------------------------------------------Q-XSSS
------------------------------------------------------------EXXX[-------o----XX-------------------------------------------------------------------------------X---
-------<---------------------------------------------------EXXXX[--------------------------------------------------------------------------E---?Q---xxxx------X---
---oo--[>------E-------------------------------------------XXXXX[----------------------------------------------------------------X-----QQ---------xxx---xx-?--XEE-
-------X]-------E--QQ----------<>-------------------------XXXXXX<------X-----------?Q--------------<>--<>------------------?Q--QQX-QQ-------E----xx<>--<>-x-Q-XSSS
--------]------------------B---[]----------------------B--XXXXXX->-B---------------------------<>--[]--[]--------------<>-----------------------xx-[]--[]--x------
----------xxxx-------------bB--[]--BB--B--------B--<>--X--XXXXXX-]-b------------<>-----BB--->--[]--[]--[]--->----------[]-------------xxxxxxxxxxxX-[]--[]---x----x
-xxxxxxxxxxBB-xxxxxxxxxxxxxxb-XXX--bb--bB--EE--Bb--[]-XX--XXXXXXXXXXX-----------[]-----bb--<]XXXX--XX--[]--<]--EE------[]----xxxxxxxxxx-XXXXXXXXXX-[]--[]----xxxxx
XXXXXXXXXXXXXXXXXXXXXXX<>XXXXXXXX--XXXXXXXXXXXXXXXXXXXXX--XXXXXXXXXXX------XX--B[XXXXXXXXXX[XXXXX--XX--XXXX[XXXXXXXXX--XXXX-XXXXXXXXXXXXXXXXXXXXXX-XXXX[]--XXXXXXX
