NNNNNNNNNNNNNNNNNNNNNNNNNNNNNNNNNNNNNNNNNNNNNNNNNNNNNNNNNNNYYNNNNNNNNNNNNNNNNNNNNNNNNNNNNNNYYNNNNNNNNNNYYNNNNNNNNNNYYNNNNNNYYNNNNNNNNNNYYNNNNNNNNNNNNNNNNNNNNNNNNN
NNNNNNNNNNNNNNNNNNNNNNNNNNNNNNNNNNNNNNNNNNNYYNNNNNNYYNNNNNNNNNNNNNNNNNNYYNNYYNNNNNNYYNNNNNNNNNNNNNNNNNNNNNNYYNNYYNNNNNNYYNNNNNNNNNNNNNNNNNNNNNNNNNNNNNNNNNNNNNNYYN
NNNNNNNNNNNNNNNNNNNNNNNNNNNNNNNYYNNNNNNNNNNNNNNNNNNNNNNYYNNNNNNYYNNNNNNNNNNNNNNNNNNNNNNNNNNNNNNNNNNNNNNNNNNNNNNNNNNNNNNNNNNNNNNNNNNNNNNNNNNNNNNNNNNNNNNYYNNNNNNNNN
NNNYYNNYYNNYYNNNNNNYYNNNNNNYYNNNNNNYYNNNNNNNNNNYYNNNNNNNNNNNNNNNNNNYYNNNNNNNNNNNNNNNNNNNNNNNNNNYYNNNNNNNNNNNNNNNNNNNNNNNNNNNNNNNNNNNNNNNNNNNNNNNNNNNNNNNNNNYYNNNNN
NNNNNNNNNNNNNNNYYNNNNNNYYNNNNNNNNNNNNNNYYNNNNNNNNNNNNNNNNNNNNNNNNNNNNNNNNNNNNNNYYNNNNNNYYNNNNNNNNNNYYNNNNNNNNNNNNNNNNNNNNNNNNNNYYNNYYNNNNNNYYNNYYNNYYNNNNNNNNNNNNN
------------------------------------------------------------------------------------------------------------------------------------------------------------------
------------------------------------------------------------------------------------------------------------------------------------------------------------------
------------------------------------------------------------------------------------------------------------------------------------------------------------------
------------------------------------------------------------------------------------------------------------------------------------------------------------------
---------------------------------------------------------------------------------------------------------------oo-------------------------------------------------
----------------------------------------------------------------E----------------------------------------------XX-------------------------------------------------
-------------------------SSSSS-------------oo------oo------------------oo--oo------oo-----------------------------------------------------------------------------
---------------------------[-------------------------------?Q--E-----------XXX------XX-----QQ----------------------QQ------QQ-------------------------------------
---------------------------[-----------------------------------------------------------------------------------------------------------------------------------oo-
------------------------S--[S------------------<----------X-------------------------------------------------------X-----------------------------------------------
------------------------SSS[-------------------[>------EEXX------------------------------------------------------------oo-----------------------------------------
---E------------------xxxx-<-x-----------------[]-------XXX--------------------------------QQ----------?Q---o------QQ------QQ----------QQ------B------------------
----<----------------xxBB-xxx-x----xxxxxxx-----[]-------XXX-----------------------------------xxxx---------o-----------------------B-------B---b---B------xxxx----
-----------<---BB-xxxxXbb--x>--xxxxx>XX<>-x----[]-------XXX--------<>----------<>------------xx<>-xBB-xx------xxx-------------xxxx-bB------b---BB--b---EExx<>-x---
-xxxx--xxxxxxxxxxxx<>XXXXXXX]XXEEXX<]XX[]--xxxx[]-----XXXXXX-------[]----------[]------Bxxxxxx-[]--xxxx-xxxxxxx--xxxxxxxxxxxxxxBB-xxb-xxxxxxB-xxxxxxB-xxxxX[]--xxx
XXXXXxx<>XXX>XXXXXX[]XXXXXXXXXXXXXX[]XXXXXXXXXXXXXXXXXXXXXXX-------XXXXXXXXXXXXXXXXXXXXXXXXXXXXXXXXXXXXXXXXXXXX--XXXXXXXXXXXXXXXXXXXxxXXXXXXxxXXXXXXxxXXXXXXXXXXXX
