NNNNNYYNNYYNNYYNNYY
NNNNNNNNNNNNNNNNNNN
NNNNNNNNNNNNNNNNNNN
NNNNNNNNNNNNNNNNNNN
NNNNNNNNNNNNNNNNNNN
-------------------
-------------------
-------------------
-------------------
-------------------
-------------------
-------------------
-------------------
-----------------?-
------------------?
---------Q?--QQ----
-----QQ------------
---------xxxxx-----
--------xx----xxxxx
-xxxxxxxx----XXXXXX
XXXXXXXXXX---XXXXXX
