NNNNNYYNNYYNNYYNNYY
NNNNNNNNNNNNNNNNNNN
NNNNNNNNNNNNNNNNNNN
NNNNNNNNNNNNNNNNNNN
NNNNNNNNNNNNNNNNNNN
-------------------
-------------------
-------------------
-------------------
-------------------
-------------------
-------------------
---------Q?--------
-------------------
-------------------
-------------------
-----QQ--QQ------QQ
-------------QQ----
-------------------
-xxxxxxxxxxxxxxxxxx
XXXXXXXXXXXXXXXXXXX
