NNNNNYYNNYYNNYYNNYY
NNNNNNNNNNNNNNNNNNN
NNNNNNNNNNNNNNNNNNN
NNNNNNNNNNNNNNNNNNN
NNNNNNNNNNNNNNNNNNN
-------------------
-------------------
-------------------
-------------------
-------------------
-------------------
-------------------
---------Q--------S
-------------------
-----?-------------
------Q------------
---------QQ--QQ--QQ
-------------------
----xxx------------
-xxxx--xxxxxxxxxxxx
XXXXX--XXXXXXXXXXXX
