NNNNNYYNNYYNNYYNNYY
NNNNNNNNNNNNNNNNNNN
NNNNNNNNNNNNNNNNNNN
NNNNNNNNNNNNNNNNNNN
NNNNNNNNNNNNNNNNNNN
-------------------
-------------------
-------------------
-------------------
-------------------
-------------------
-------------------
-----QQSSSSSSQ---?-
-------------------
-------------------
-------------------
-----QQ--QQ--S?S-Q?
-------------------
-------------------
-xxxxxxxxxxxxxxxxxx
XXXXXXXXXXXXXXXXXXX
