NNNNNYYNNYYNNYYNNYY
NNNNNNNNNNNNNNNNNNN
NNNNNNNNNNNNNNNNNNN
NNNNNNNNNNNNNNNNNNN
NNNNNNNNNNNNNNNNNNN
-------------------
-------------------
-------------------
-------------------
-------------------
-------------------
-------------------
-------------------
-------------------
-------------------
-------------------
-----QQ--QQ--QQ--QQ
-------------------
---------------xxx-
-xxxxxxxxxxxxxxx--x
XXXXXXXXXXXXXXXX-XX
