NNNNNYYNNYYNNYYNNYY
NNNNNNNNNNNNNNNNNNN
NNNNNNNNNNNNNNNNNNN
NNNNNNNNNNNNNNNNNNN
NNNNNNNNNNNNNNNNNNN
-------------------
-------------------
-------------------
-------------------
-------------------
-------------------
-------------------
---------Q---QS----
-------------------
-------------------
-------------------
-----?Q--QQ--QQ--QQ
-------------------
----xxx------------
-xxxx--xxxxxxxxxxxx
XXXXX-XXXXXXXXXXXXX
