NNNNNYYNNYYNNYYNNYY
NNNNNNNNNNNNNNNNNNN
NNNNNNNNNNNNNNNNNNN
NNNNNNNNNNNNNNNNNNN
NNNNNNNNNNNNNNNNNNN
-------------------
-------------------
-------------------
-------------------
-----?-------------
-------------------
-------------------
---------------X---
---------------X---
---------------X---
---------QQ--QQXS?Q
------?------------
-----xxxxx---------
----xx----xxxxxxxxx
-xxxx----XXXXXXXXXX
XXXXX----XXXXXXXXXX
