NNNNNNNNNNNNNNNNNNN
NNNNNYYNNYYNNYYNNYY
NNNNNNNNNNNNNNNNNNN
NNNYYNNYYNNYYNNYYNN
NNNNNNNNNNNNNNNNNNN
-------------------
-------------------
-------------------
-------------------
-------------------
-------------------
-------------------
-------------------
-------------------
-------------------
-----oo---o---o--oo
---------?---Q-----
-------------------
-----------E-------
-xxxxxxxxxxxxxxxxxx
XXX<>XXE<XXX<XX<>XX
