NNNNNNNNNNNNNNNNNNN
NNNNNYYNNYYNNYYNNYY
NNNNNNNNNNNNNNNNNNN
NNNYYNNYYNNYYNNYYNN
NNNNNNNNNNNNNNNNNNN
-------------------
-------------------
-------------------
-------------------
-------------------
-------------------
--------------o----
-------------Q-----
-------------------
-------------------
-----oo----------ox
---------Qo--S---xx
---<------------xx-
-----------Exxxxx--
-xxxxxxxxxxxx--<>-o
XXXXXXXE<XXX<--[]-X
