NNNNNNNNNNNNNNNNNNN
NNNNNYYNNYYNNYYNNYY
NNNNNNNNNNNNNNNNNNN
NNNYYNNYYNNYYNNYYNN
NNNNNNNNNNNNNNNNNNN
-------------------
-------------------
-------------------
-------------------
-------------------
-------------------
-------------------
-----------------o-
------------------o
-------------------
---<>oo--oo--------
---[>--------Q-----
---X---------------
-----------E---<---
-xxxxxxxxxxxxxxxxxx
XXXXXXX<>XXX<XXXXXX
