NNNNNNNNNNNNNNNNNNN
NNNNNYYNNYYNNYYNNYY
NNNNNNNNNNNNNNNNNNN
NNNYYNNYYNNYYNNYYNN
NNNNNNNNNNNNNNNNNNN
-------------------
-------------------
-------------------
-------------------
-------------------
-------------------
----------o--------
---------Q---------
---<>--------------
---[]o-------oo----
---X]-------------o
------o--?------xxx
---------------xx--
-------Exxxxxxxx<--
-xxxxxxxx---<--E[--
XXXXXXXX<--E[--XX--
