NNNNNNNNNNNNNNNNNNN
NNNNNYYNNYYNNYYNNYY
NNNNNNNNNNNNNNNNNNN
NNNYYNNYYNNYYNNYYNN
NNNNNNNNNNNNNNNNNNN
-------------------
-------------------
-------------------
-------------------
-------------------
-------------------
-------------------
-----oo------------
-------------------
-------------------
---------oo--------
-------------Qo--Q?
-------------------
---<---------------
-xxxxxxxxxxxxxxxxxx
XXXXXXX<>XXE<XXE<XX
