NNNNNNNNNNNNNNNNNNN
NNNNNYYNNYYNNYYNNYY
NNNNNNNNNNNNNNNNNNN
NNNYYNNYYNNYYNNYYNN
NNNNNNNNNNNNNNNNNNN
-------------------
-------------------
-------------------
-------------------
-------------------
-------------------
-------------oo----
-----oo--oo-xx-xxxx
-----X----xxx-xx<>-
---------xx<>-XX[]-
--------xx-[]---[]-
---<--xxx--[]---[]o
-----xx<>--[]---[]-
----xx-[]--[]--E[]-
-xxxx--[]--[]--XXXX
XXXXX--XXXXXXXXXXXX
