NNNNNNNNNNNNNNNNNNN
NNNNNYYNNYYNNYYNNYY
NNNNNNNNNNNNNNNNNNN
NNNYYNNYYNNYYNNYYNN
NNNNNNNNNNNNNNNNNNN
-------------------
-------------------
-------------------
-------------------
-------------------
-------------------
-------------------
-------------------
-------------------
------------------o
-----oo------oo--o-
---------Qo-------x
-------E---------xx
-----------xxxxxxx-
-xxxxxxxxxxx<--E<X-
XXX<>XXX<XXX[---[XX
