NNNNNNNNNNNNNNNNNNN
NNNNNYYNNYYNNYYNNYY
NNNNNNNNNNNNNNNNNNN
NNNYYNNYYNNYYNNYYNN
NNNNNNNNNNNNNNNNNNN
-------------------
-------------------
-------------------
-------------------
-------------------
-------------------
-------------------
----E--------------
---<>--------------
---[]--------------
---[]oo-------o--oo
---[X----Qo--Q-----
-------------------
-------E---E-------
-xxxxxxxxxxxxxxxxxx
XXXXXXXX<XXX<XX<>XX
