NNNNNNNNNNNNNNNNNNN
NNNNNYYNNYYNNYYNNYY
NNNNNNNNNNNNNNNNNNN
NNNYYNNYYNNYYNNYYNN
NNNNNNNNNNNNNNNNNNN
-------------------
-------------------
-------------------
-------------------
-------------------
-------------------
-------------------
-------------------
-------------------
-------------------
-----oo------oo----
---------Qo------Qo
-------------------
---<---E-----------
-xxxxxxxxxxxxxxxxxx
XXXXXXXX<XX<>XXE<XX
