NNNNNNNNNNNNNNNNNNN
NNNNNYYNNYYNNYYNNYY
NNNNNNNNNNNNNNNNNNN
NNNYYNNYYNNYYNNYYNN
NNNNNNNNNNNNNNNNNNN
-------------------
-------------------
-------------------
-------------------
-------------------
-------------------
-------------------
-------------------
-------------------
-------------------
-----oo----------oo
---------Qo<-oo----
-------------------
------------------x
-xxxxxxxxxxxxxxxxxx
XXX<>XXE<XXXXXX<>XX
