NNNNNNNNNNNNNNNNNNN
NNNNNNNNNNNNNNNNNNN
NNNNNNNNNNNNNNNNNNN
NNNNNYYNNYYNNYYNNYY
NNNNNNNNNNNNNNNNNNN
-------------------
-------------------
-------------------
-------------------
-------------------
-------------------
-------------------
-------------------
-------------------
-------------------
-------------<>----
-------------[]--<>
-----<-------[]--[]
---------<---[]--[]
-xxxxxxxxxxxx[]--XX
XXXXXXXXXXXXXXX--XX
