NNNNNNNNNNNNNNNNNNN
NNNNNNNNNNNNNNNNNNN
NNNNNNNNNNNNNNNNNNN
NNNNNYYNNYYNNYYNNYY
NNNNNNNNNNNNNNNNNNN
-------------------
-------------------
-------------------
-------------------
-------------------
-------------------
-------------------
-------------------
-------------<E--<E
-------------[>--[>
-------------X]--X]
--------------X---X
-------------------
---------E---------
-xxxxxxxxxxxxxxxxxx
XXXXX<>XXX<XXXXXXXX
