NNNNNNNNNNNNNNNNNNN
NNNNNNNNNNNNNNNNNNN
NNNNNNNNNNNNNNNNNNN
NNNNNYYNNYYNNYYNNYY
NNNNNNNNNNNNNNNNNNN
-------------------
-------------------
-------------------
-------------------
-------------------
-------------------
-------------------
-------------------
-------------------
-------------------
---------<E--------
-----<---[>--------
---------X--------<
-----------------E-
-xxxxxxxxxxxxxxxxxx
XXXXXXXXXXXXX<>XXXX
