NNNNNNNNNNNNNNNNNNN
NNNNNNNNNNNNNNNNNNN
NNNNNNNNNNNNNNNNNNN
NNNNNYYNNYYNNYYNNYY
NNNNNNNNNNNNNNNNNNN
-------------------
-------------------
-------------------
-------------------
-------------------
-------------------
-----o-------------
---XXXX------------
-------------------
--------------E----
---------<>--<>----
---------[]--[]--->
---------[]--[]--<]
----xxx--[]--[]--[]
-xxxx--xx[]-XXXXXXX
XXXXX-EXXXXXXXXXXXX
