NNNNNNNNNNNNNNNNNNN
NNNNNNNNNNNNNNNNNNN
NNNNNNNNNNNNNNNNNNN
NNNNNYYNNYYNNYYNNYY
NNNNNNNNNNNNNNNNNNN
-------------------
-------------------
-------------------
-------------------
---SSSSSSSSSSSSSSSS
-------------------
-------------------
-------------------
-------------------
-------------------
-----------xxxxxxx-
-------xxxxx------x
-----xxxXE<>-----<>
---xxx>--X[]-----[]
-xxx-<]--X[]-<>--[]
XXXX-[]--XXXXX]--XX
