NNNNNNNNNNNNNNNNNNN
NNNNNNNNNNNNNNNNNNN
NNNNNNNNNNNNNNNNNNN
NNNNNYYNNYYNNYYNNYY
NNNNNNNNNNNNNNNNNNN
-------------------
-------------------
-------------------
-------------------
-------------------
-------------------
-------------------
-------------------
------E--<E--------
-----<>--[>--------
-----[]--[]--------
-----[XX-XXX-------
------------xxxx---
-----------xx<>-x--
-xxxxxxxxxxx-[]--xx
XXXXXXXXXXXXXXXXX<>
