---------------------------------------------------------------------------------------------------------------------------------------------------------------
---------------------------------------------------------------------------------------------------------------------------------------------------------------
---------------------------------------------------------------------------------------------------------------------------------------------------------------
---------------------------------------------------------------------------------------------------------------------------------------------------------------
---------------------------------------------------------------------------------------------------------------------------------------------------------------
---------------------------------------------------------------------------------------------------------------------------------------------------------------
-----------------------E-----E--------------------------------------------------------------------ooooo--------------------------------------------------------
-----------------------SS---<>-----------------------------------------S------------------------SSSSSSSSSSSSSSS------------------------------------------------
-------------xxx------------[]---------------------------------------------------------------------------------------------------------------------------------
------------xxX-x-----------[]-------------------------------------------------------------------------------xxxxxxxxx---------xxx--xxx----------------------XX
-----------xxXX--x----S-----[]----------------------------xxxx---------------------------------xxxxxxxxxxxxxxx--------x-------xx--xxx--x-----------------------
----------xxXXX---x----SSSSSXXX----------xx--------------xx<>-x-------------------------------xx--?SSSSSSSSSSS---------x---?-xx---XXX---x-xxxxx----------------
---------xxXXXX----x--------------------xx-x------------xx-[]--x-----------------------------xx-------------------------x---xx----XX-----xx----x---------------
---xxx--xxXXXXX-----x------------------xx---x--xxxxx---xx--[]---x-xxx-xxxxx-B-xxx-----------xx------------------------X--x-xx-----------XXX-----x-xxx----------
-xxx--xxxXXXXXX------xxxxxxxxxxxxxxxxxxx-----xxx----xxxx---[]----xx--xx----xxxx--xxxxxxxxxxxx------E-E----------------X---xx---------------------xx--xxxxxxxxxx
XXXX--XXXXXXXXXXXXXXXXXXXXXXXXXXXXXXXXXX-----XXX---XXXXXXXXXXXXXXXX--XX---XXXXX--XXXXXXXXXXXX---XXXXXXXXXXXXXXXXXXXXXXXXXXXXE--------------------XX--XXXXXXXXXX
