---------------------------------------------------------------------------------------------------------------------------------------------------------------
---------------------------------------------------------------------------------------------------------------------------------------------------------------
---------------------------------------------------------------------------------------------------------------------------------------------------------------
---------------------------------------------------------------------------------------------------------------------------------------------------------------
---------------------------------------------------------------------------------------------------------------------------------------------------------------
---------------------------------------------------------------------------------------------------------------------------------------------------------------
--------------------------------------------------------------E------------------------------------------------------------------------------------------------
----------------SSS-----------------------------------S?SSSS?S-------------------------------------------------------------------------------------------------
--------------------------------------------------------------------------------------------------E------------------------------------------------------------
-------------xxxxxxxxxx----------------------------------------------------------------------------------------------------------------------------------------
----------xxxx---x-----xx-------------ooo----------------------------------------------------------xxxxxx-------------------------------E----------------------
--------xxx-<>---S----<>-x----------------xxx--------S?SSSSSSS---xx----------------xx------------xxx--<>-x----------------------------------------------xxxx---
-------xx<>-[]--------[]--x--------------xxX-x---xxxx-----------xx-x--------------xx-x----------xx<>--[]--x----------------E---------------------------xx<>-x--
------xx-[]-[]--------[]---x------------xx-X--x-xx<>-x---------xx---xxxx-xxx-----xx---x--------xx-[]--[]---x--------B----------------------------xxx--xx-[]--x-
-xxxxxx--[]-[]--------[]----xxxxxxxxxxxxx--X---xx-[]--xxxxxxxxxx-----x--xx--xxxxxx-----xxxxxxxxx--[]--[]----xxxxxxxxxxxxxxxxxxxxxxxxxxxxxxxxxxxxxx-Exxx--[]---x
XXXXXXXXXXXXXXXXXXXXXXXXXXXXXXXXXXXXXXXXXXXXXXXXXXXXXXXXXXXXXXXX-----X--XX--XXXXXX-----XXXXXXXXXXXXX--XXXXXXXXXXXXXXXXXXXXXXXXXXXXXXXXXXXXXXXXXXXX--XXXXXXXXXXX
