---------------------------------------------------------------------------------------------------------------------------------------------------------------
---------------------------------------------------------------------------------------------------------------------------------------------------------------
---------------------------------------------------------------------------------------------------------------------------------------------------------------
---------------------------------------------------------------------------------------------------------xx----------------------------------------------------
--------------------------------------------------------------------------------------------------------xx-x---------------------------------------------------
-------------------------------------------------------------------------------------------------------xx---x--------------------------------------------------
-------------------------------------------------------------------ooooooooooooooo-----xxx------------xx-----x-------------------------------------------------
-----------------------------------------------------------------SSSSSSSSSSSSSSSSSSSSSxx--x-----------xS------x------------------------------------------------
--------------oooo-------------------------------------------------------------------xx----x-----xxxx-x--------x-----------------------------------------------
------------------------------------------------------------------------------------xx------x---xx---xx---------x----------------------------------------------
----------------------------------------------------------------xxxxxxxxxxxxxxxxxxxxx--------x-xx-----x----------x-----------------------------ooo-------------
----XX-----xxx-----------------------------------------S-------xx--?SSSSSSSSSSSSSSSSS--X------xx------SS----------xxx-------------------QQQ--------------------
----------xxX-x-----------------xxx---------------------------xx----------------------XX------<>----------<E------<>-x----xxxx---------------------------------
---------xx-X--x---------------xx--x---------xxx-xxx---------xx----------------------XXX------[]----------[>------[]--x--xx<>-x--------------------------------
-xxxxxxxxx--X---xxxxxxxxxxxxxxxxE---xxxxxxxxxx--xx--xxxxxxxxxx------------------E---XXXX------[]----------[]------[]---xxx-[]--xxxxxxxxxxxxxxxxxxxxxxxxxxxxxxxx
XXXXXXXXXXXXXXXXXXXXXXXXXXXXXXXXXXXXXXXXXXXXXX--XX--XXXXXXXXXX---XXXXXXXXXXXXXXXXXXXXXXXXXXXXXXXXXXXXXXXXXXXXXXXXXXXXXXXXXXXXXXXXXXXXXXXXXXXXXXXXXXXXXXXXXXXXXX
