NNNNNNNNNNNNNNNYYNNYYNNYYNNNNNNNNNNNNNNNNNNNNNNNNNNYYNNNNNNNNNNNNNNYYNNNNNNNNNNNNNNYYNNNNNNNNNNNNNNNNNNNNNNNNNNYYNNNNNNNNNNNNNNNNNNYYNNNNNNNNNNNNNNNNNNNNNNYYNNNNN
NNNYYNNYYNNYYNNNNNNNNNNNNNNNNNNNNNNYYNNYYNNNNNNYYNNNNNNNNNNNNNNYYNNNNNNNNNNNNNNNNNNNNNNNNNNNNNNNNNNYYNNYYNNNNNNNNNNYYNNNNNNYYNNYYNNNNNNNNNNYYNNNNNNNNNNNNNNNNNNNNN
NNNNNNNNNNNNNNNNNNNNNNNNNNNYYNNNNNNNNNNNNNNYYNNNNNNNNNNNNNNNNNNNNNNNNNNNNNNNNNNNNNNNNNNNNNNYYNNNNNNNNNNNNNNYYNNNNNNNNNNNNNNNNNNNNNNNNNNNNNNNNNNYYNNNNNNNNNNNNNNNNN
NNNNNNNNNNNNNNNNNNNNNNNNNNNNNNNNNNNNNNNNNNNNNNNNNNNNNNNNNNNYYNNNNNNNNNNYYNNNNNNYYNNNNNNYYNNNNNNYYNNNNNNNNNNNNNNNNNNNNNNNNNNNNNNNNNNNNNNYYNNNNNNNNNNYYNNNNNNNNNNNNN
NNNNNNNNNNNNNNNNNNNNNNNNNNNNNNNYYNNNNNNNNNNNNNNNNNNNNNNYYNNNNNNNNNNNNNNNNNNYYNNNNNNNNNNNNNNNNNNNNNNNNNNNNNNNNNNNNNNNNNNYYNNNNNNNNNNNNNNNNNNNNNNNNNNNNNNYYNNNNNNYYN
------------------------------------------------------------------------------------------------------------------------------------------------------------------
------------------------------------------------------------------------------------------------------------------------------------------------------------------
------------------------------------------------------------------------------------------------------------------------------------------------------------------
----------------------------------------------------------------------------------------------------------------------------------xxxx----------------------------
-----------o-----------------------------------------------------------------------??--------------------------------------------xx---x---------------------------
-----------o----------------------xx--------------------------------------------------------------------------------o-----------xx-----xx-------------------------
------------o----------?Q--------xx-x-----SSS--oo--------------oo-----------------XX-----------------------EEXXQQ--o-----------xx--------x------------------------
--------o---XX------------S------x---x--o----------------------------------------XXXxx----------------------XX---SS-----------xxE---------xoo---------------------
---o---oo------E------------xxx-xx----xxxx--------------------------------------EXXXX-x------------oo---o--------------------xxE-----------x----------------------
----o------xxxxxxxxxxxxxxxxxx--xx------o--x-----------X<-----------------------EXXXX---xxx---------XXX-oo-------------------xxXX------------x---------------------
----o---xxxx--x-Qx-QQ--xXX-SS--<>----------x---------XX[>----------------------XXXXX---<>-x------------o--------S----------xxXXX-------------x-----------------B--
-------xxXXX-XX--S----XXXX-----[]---o-------x------?QX-[]--<>------QQ---------XXXXXX---[]--x------------------------------xxEXXXX-------------x----<-----------b--
------xx--------------XXXX-EE--[]------------x---------[]--[]--------------BXXXXXXXX---[]---x----------------------------xxEXXXX]--?-----------x-----------QQ-----
-----xx--------------XXXXXXXX--[]--o-------E--x------xx[]--[]----------<>--XXXXXXXXXS--[]---ExxxxxxxxxxxxxxxxxxxxxxxxxxxxxXXXXXX]---?--->------Exx-xxx-BB-------B-
-xxxxx---------XXXXXXXXXXXXXX--[]--XXXXXXXXXE--xxxxxxx-XXXXXX----------[]-XXXXXXXXXX---[]--EXXXE<>XXXXXXXXXXXXXXXXXXXXX<>XXXXXXX]------<]-------E-xx>-xxxxxxxxxxxx
XXXXXXXXX-------XXXXXXXXXXXXX--XXXXXXXXXXXXXXXXXXXXXXX-XXXXXX--XX--XXXXXXXXXXXXXXXXXXXXXXXX-----[]XXXXXXXXXXXXXXXXXXXXX[]XXXXXXXX----XX[XXXXXXXXXXXX]XXXXXXXXXXXXX
