NNNNNNNYYYYYYYYNNNNNNNNYYYYYYYYNNNNNNNNYYYYYYYYNNNNNNNNYYYYYYYYNNNNNNNNYYYYYYYYNNNN
NNNYYNYYYNNNNNNNNNNYYNYYYNNNNNNNNNNYYNYYYNNNNNNNNNNYYNYYYNNNNNNNNNNYYNYYYNNNNNNNNNN
NNNNNNNYYYYNNNNYYNNNNNNYYYYNNNNYYNNNNNNYYYYNNNNYYNNNNNNYYYYNNNNYYNNNNNNYYYYNNNNYYNN
NNNNNNYNNNYYNNNNYYNNNNYNNNYYNNNNYYNNNNYNNNYYNNNNYYNNNNYNNNYYNNNNYYNNNNYNNNYYNNNNYYN
NNNNNYNNNNNNNNNNNNYNNYNNNNNNNNNNNNYNNYNNNNNNNNNNNNYNNYNNNNNNNNNNNNYNNYNNNNNNNNNNNNY
-----------------------------------------------------------------------------------
-----------------------------------------------------------------------------------
-----------------------------------------------------------------------------------
-----------------------------------------------------------------------------------
-----------------------------------------------------------------------------------
-----------------------------------------------------------------------------------
------------------------<o-E---------------------------ooooo--?--------?E??QQ------
------------------------[Q<>QQQX-----------E--------o---?SSS??-----oo---S----------
------------------------[-[]---X----------<>-------o----------------xxx------------
---oo--------------oo-E?--QQ---X-------??-[]-----------------------xx--xxxxxxxxxxxx
-------?QQQQQQQ-------o?-------XE---o-o??QQXQQQ-----xxxxxxxxxxxx--xx----x-EE-xQ-x-S
------o?------------xxxxxx--QQQXE--o---------------xx-E?Q??SSSS-xxx-----Q----?-<>--
------E---E----EE--x---E?-------------E-----------xx-<>----------<>---E--------[]--
-----Bxxxxxxxxxxxxxx--->--x----E--B-xxxxxxxxxxxxxxx--[]----------[]--->--------[]--
-xxxxxxEEEEEXXXXE<>--------xxxxxxxxxx--EXEXXXXXEE<>--[]E-------EE[]--<]E-------[]E-
XXXXXXXXXXXXXXXXX[]-------XXXXXXXXXXX--XXXXXXXXXX[]--XXXXXXXXXXXXXXXX[]XXX-----X]X<
