NNNNNNNYYYYYYYYNNNNNNNNYYYYYYYYNNNNNNNNYYYYYYYYNNNNNNNNYYYYYYYYNNNNNNNNYYYYYYYYNNNN
NNNYYNYYYNNNNNNNNNNYYNYYYNNNNNNNNNNYYNYYYNNNNNNNNNNYYNYYYNNNNNNNNNNYYNYYYNNNNNNNNNN
NNNNNNNYYYYNNNNYYNNNNNNYYYYNNNNYYNNNNNNYYYYNNNNYYNNNNNNYYYYNNNNYYNNNNNNYYYYNNNNYYNN
NNNNNNYNNNYYNNNNYYNNNNYNNNYYNNNNYYNNNNYNNNYYNNNNYYNNNNYNNNYYNNNNYYNNNNYNNNYYNNNNYYN
NNNNNYNNNNNNNNNNNNYNNYNNNNNNNNNNNNYNNYNNNNNNNNNNNNYNNYNNNNNNNNNNNNYNNYNNNNNNNNNNNNY
-----------------------------------------------------------------------------------
-----------------------------------------------------------------------------------
-----------------------------------------------------------------------------------
-----------------------------------------------------------------------------------
-----------------------------------------------------------------------------------
-----------------------------------------------------------------------------------
--------------------------E---------------E------------------------------ooQ-------
--------QQQQQQQX--------S?QQSSSSSSS-----QQQQQQQX--------QQQQQQQX--------ooS-QQQ<E--
---------------X-------------------------------X-------Q-------X--------o------[>--
---------------X-------------------------------X---------------X-------oo-E----[]--
------oQE-E----XE------E--E-----EE-----EEE-E---XE--oo-o?EEE----XE--oo-oo--E----X]--
---oo---QQQQQQQXSSB-o-oQ??QQQQQESSS?o-oQQQQQQQQXE-------?QQQQQQX<-----o--SS?SS?-XE-
-------E----------b--BE-------------------------------------------B----E-----------
-------E-------E-E-E-b--E------------BE--------E--B----E-------E--B--B--E----------
-xxxxxxxxxxxxxxxxxxxxxxxxxxxxxxxxxxxxxxxxxxxxxxxxxxxxxxxxxxxxxxxxxxxxxxxxxxxxxxxxxx
XXXXX<>XXXXXXXXXXXXXXXXEXXXXXXXXXX<XXXXXXXXXXXXXXXXXX<>XXXXXXXXXXXXXXX-XXXXXXXXXXXX
