NNNNNYYNNYYNNYYNNYYNNYYNNYYNNYYNNYYNNYYNNYYNNYYNNYYNNYYNNYYNNYYNNYYNNYYNNYYNNY
------------------------------------------------------------------------------
------------------------------------------------------------------------------
------------------------------------------------------------------------------
------------------------------------------------------------------------------
------------------------------------------------------------------------------
------------------------------------------------------------------------------
------------------------------------------------------------------------------
--------------------------E---------------------------------------------------
--------xxx--------------<>---------------------------------------------------
-------xx<Ex-------------[]---------------------------------------------------
------xx-[]-x------------[]----------<>-------------------------------E-------
-----xx--[]--xxx----xxxx-X------xxxx-[]-------E--<E--<>--<E---E------<>--<E--<
----xxE--[]--<>-x--xx<E-x------xx<>-x[]--<>--<>--[>--[]--[>--<>--<---[]--[>--[
---xx<>--[]--[]--xxx-[]--xxxxxxx-[]--[]--[]--[]--[]--[]--[]--[]--[>--[]--[]--[
-xxxX[]XXXXXXXXXX<>XXXXXXXEXX<>XXXXXXXXXXXXXXXXXXXXXXXXXXXXXXXXXXX]--XXXXXXXXX
XXXXXXXXXXXXXXXXX[]XXXXXXXXXX[]XXXXXXXXXXXXXXXXXXXXXXXXXXXXXXXXXXXXXXXXXXXXXXX
