NNNNNNNYYYYYYYYNNNNNNNNYYYYYYYYNNNNNNNNYYYYYYYYNNNNNNNNYYYYYYYYNNNNNNNNYYYYYYYYNNNN
NNNYYNYYYNNNNNNNNNNYYNYYYNNNNNNNNNNYYNYYYNNNNNNNNNNYYNYYYNNNNNNNNNNYYNYYYNNNNNNNNNN
NNNNNNNYYYYNNNNYYNNNNNNYYYYNNNNYYNNNNNNYYYYNNNNYYNNNNNNYYYYNNNNYYNNNNNNYYYYNNNNYYNN
NNNNNNYNNNYYNNNNYYNNNNYNNNYYNNNNYYNNNNYNNNYYNNNNYYNNNNYNNNYYNNNNYYNNNNYNNNYYNNNNYYN
NNNNNYNNNNNNNNNNNNYNNYNNNNNNNNNNNNYNNYNNNNNNNNNNNNYNNYNNNNNNNNNNNNYNNYNNNNNNNNNNNNY
-----------------------------------------------------------------------------------
-----------------------------------------------------------------------------------
-----------------------------------------------------------------------------------
-----------------------------------------------------------------------------------
-----------------------------------------------------------------------------------
-----------------------------------------------------------------------------------
------------------------------------------oo-------oo-SEE------E---oo--EE----------
-------QQQQQQQQX-X----------SS----------ooo-?QQSSSSSSS-SSS?SSSSSSSSSSSSSQQ?QQQQXE--
---------------X-X--------------<>------oooo-----------------------------------XX<E
---------------XEX-----E--------[]-----o---------------------------------------XX[>
---oo-?-EEE----XEX-oo--o?-E----E[]----ooo------EEE---EEEE-E-----EE----EEEEEE---XX[]
-------Q?QQ?QQQX-X----o-QQQQ?QQ-XX<Qo-o------QSSSSESSSS??QQ?QQQSSSESSESQ?QQQQQQXX[]
------------------B-------------------------------S---------------S--S----------XXX
---------------E-Eb--BEEE------------B-E--E--xxxx------------------------------E---
-xxxxxxxxxxxxxxxxxxxxxxxxxxxxxxxxxxxxxxxxxxxxx---xxxxxxxxxxxxxxxxxxxxxxxxxxxxxxxxxx
XXXXX<>EXXXXXXXXXXXXXXXXXEXEXXXXXXXXXXXXXXXXXX---XXXXXXXXXXXXXXXXXXXXXXXXXXXXXXXXXX
