NNNNNYYNNYYNNYYNNYYNNYYNNYYNNYYNNYYNNYYNNYYNNYYNNYYNNYYNNYYNNYYNNYYNNYYNNYYNNY
------------------------------------------------------------------------------
------------------------------------------------------------------------------
------------------------------------------------------------------------------
------------------------------------------------------------------------------
------------------------------------------------------------------------------
------------------------------------------------------------------------------
------------------------------------------------------------------------------
------------------------------------------------------------------------------
------------------------------------------------------------------------------
------------------------------------------------------------------------------
----------------------------------------------E-------------------E----------<
------E-----Q--------------------------------<>---------------<--<>------<>--[
-----<>------------------------------------------<E-------E--<>----------[]--[
-------------------------<E----------------------<>------<>--------------[]--[
-xxxxxxxxxxxxxxxxxxxxxxxxxxxxxxxxxxxxxxxxxxxxxxxxxxxxxxxxxxxxxxxxxxxxxxxx[]--X
XXXXXXXXX<>XX<>XX<>XX<>XXX>XX<>XX<>XX<>XX<>XXXXXXXXXX<>XXXXXXXXXXXXXX<>XXXXXXX
