NNNNNYYNNYYNNYYNNYYNNYYNNYYNNYYNNYYNNYYNNYYNNYYNNYYNNYYNNYYNNYYNNYYNNYYNNYYNNY
------------------------------------------------------------------------------
------------------------------------------------------------------------------
------------------------------------------------------------------------------
------------------------------------------------------------------------------
------------------------------------------------------------------------------
------------------------------------------------------------------------------
------------------------------------------------------------------------------
--------------E---------------------------------------------------------------
-------------<>---------------------------------------------------------------
-------------[]--------------------------------------------------------------o
-------------[]-------------------E-------------------------------------------
-----<E-------X------------------<>---E--<------------------------------------
------>---E----------------xxxxx-----<>--------------------------------------x
---------<>-xxxxxxxxxxxxx-xxX<>-x------xxxxxx--xxxxxxxxx-----<------xxxxx---xx
-xxxxxxxxxxxxXXXX<>XE<>X-xx-X[]--xxxxxxx-<>X-xxx-<>X-xE-xxxxxxxxxxxxx<>X-xxxx<
XXXXXXXXXXXXXXXXX[]XX[]XX<>XXXXXXXXXXXXX-[]XX<>X-[]XX<>XX<>XX<>XX<>XX[]XX<>XX[
