NNNNNYYNNYYNNYYNNYYNNYYNNYYNNYYNNYYNNYYNNYYNNYYNNYYNNYYNNYYNNYYNNYYNNYYNNYYNNY
------------------------------------------------------------------------------
------------------------------------------------------------------------------
------------------------------------------------------------------------------
------------------------------------------------------------------------------
------------------------------------------------------------------------------
------------------------------------------------------------------------------
------------------------------------------------------------------------------
------------------------------------------------------------------------------
-----------------------------------------<-----------<------------------------
-----------------------------------------[-----------[E---E------E------------
---------------o---------------------<>--[E----------[>--<>---E---------------
----------E-------------------E------[]--X]--<E------X]--[]--<>--<>------<E--<
------E--<>------------------<>------[]--X]--[>--<>--[]--[]--[]--[]--<E--[>--[
-----<>-------------------------xxxxx[]--[]--[]--[]--[]--[]--[]--[]--[>--[]--[
-xxxxxxxxxxxxxxxxxxxxxxxxxxxxxxxx<>X-[]--XXXXXXXXXX--XXXXXXXXXXXXXXXXX]--XXXXX
XXXXX-XXXXXXX<>XX<>XX<>XX<>XXXXXX[]XXXXXXXXXXXXXXXX--XXXXXXXXXXXXXXXXXXXXXXXXX
