NNNNNYYNNYYNNYYNNYYNNYYNNYYNNYYNNYYNNYYNNYYNNYYNNYYNNYYNNYYNNYYNNYYNNYYNNYYNNY
------------------------------------------------------------------------------
------------------------------------------------------------------------------
------------------------------------------------------------------------------
------------------------------------------------------------------------------
------------------------------------------------------------------------------
------------------------------------------------------------------------------
------------------------------------------------------------------------------
------------------------------------------------------------------------------
------------------------------------------------------------------------------
------------------------------------------------------------------------------
--------------------------------------------------E-----------E---------------
--------------E--<E---------------------------E--<>----------->-------------xx
-------------<>--->------------------<>--<>--<>--------------<----E--------xx<
---B---------------------------------->--------------------------<>----xxxxx-[
-xxxxxxxxxxxxxxxxxxxxxxxxxxxxxxxxxxxxxxxxxxxxxxxxxxxxxxxxxxxxxxxxxxxxxxxE<>--[
XXXXX<>XX<>XXXXXXXXXX<>XX<>XX<>XX<>XXXXXXXXXXXXXXXXXX<>XX<>XXXXXXXXXX<>XX[]--X
