NNNNNYYNNYYNNYYNNYYNNYYNNYYNNYYNNYYNNYYNNYYNNYYNNYYNNYYNNYYNNYYNNYYNNYYNNYYNNY
------------------------------------------------------------------------------
------------------------------------------------------------------------------
------------------------------------------------------------------------------
------------------------------------------------------------------------------
-----X------------------------------------------------------------------------
------------------------------------------------------------------------------
------------------------------------------------------------------------------
------------------------------------------------------------------------------
--------------E---------------------------------------------------------------
-------------<>----------<E---------------xxxxxx------------------------------
--------xxxx-[]-----xxxx-[>-------------xxx--<>-x-----E---E-------------------
-------xx<>-xXXX---xx<>-xXX-------E----xx<>--[]--x---<>--<>---E-----?<--------
------xx-[]--x----xx-[]--x--xxxx-<>---xx-[]--[]---xx---------<>--------------<
----xxx--[]---xxxxx--[]---xxx<>-x---xxx--[]--[]--<>-x----------------------xxx
-xxxx<>--[]----x-<>--[]----x-[]--xxxx<>--[]--[]--[]--xxxxxxxxxxxxxxxxxxxxxxx-<
XXXXX[]--XXXXXXX-[]--XXXXXXXXXXXXXXXX[]--XXXXXXXXXXXXXXXXXXXXXXXX<>XX<XXX<>X-[
