NNNNNYYNNYYNNYYNNYYNNYYNNYYNNYYNNYYNNYYNNYYNNYYNNYYNNYYNNYYNNYYNNYYNNYYNNYYNNY
------------------------------------------------------------------------------
------------------------------------------------------------------------------
------------------------------------------------------------------------------
------------------------------------------------------------------------------
------------------------------------------------------------------------------
------------------------------------------------------------------------------
------------------------------------------------------------------------------
------------------------------------------------------------------------------
------------------------------------------------------------------------------
--------------------------xxxx-----------------------------------<E-----------
------------------xxxxxxxxx---x----------<---<E--<E-----------E--[>-----------
----------------xxx---x--<>----x----xxxx-----[>--[>--<>-------E--[]-----------
-----xxx------Exx<>--<>--[]---E-x--xx<>-x----[]--[]--[]--<>--<>-X[]--<---<E--<
----xxE-xxxxxxxx-[]--[]--[]--<>--xxx-[]--xxx-[]--[]--[]--[]--[]XXX]--[>--[>--[
-xxxx<>XX<>XX<>--[]--[]-E[]--[]XX<>--[]--<>-x[]--XXXXXXXXXXXXXXXXXXXXX]--X]--[
XXXXX[]XX[]XX[]--XXXXXXXXXXXXXXXX[]--XXXXXX-XXXXXXXXXXXXXXXXXXXXXXXXXXXXXXX--X
