NNNNNNNYYYYYYYYNNNNNNNNYYYYYYYYNNNNNNNNYYYYYYYYNNNNNNNNYYYYYYYYNNNNNNNNYYYYYYYYNNNN
NNNYYNYYYNNNNNNNNNNYYNYYYNNNNNNNNNNYYNYYYNNNNNNNNNNYYNYYYNNNNNNNNNNYYNYYYNNNNNNNNNN
NNNNNNNYYYYNNNNYYNNNNNNYYYYNNNNYYNNNNNNYYYYNNNNYYNNNNNNYYYYNNNNYYNNNNNNYYYYNNNNYYNN
NNNNNNYNNNYYNNNNYYNNNNYNNNYYNNNNYYNNNNYNNNYYNNNNYYNNNNYNNNYYNNNNYYNNNNYNNNYYNNNNYYN
NNNNNYNNNNNNNNNNNNYNNYNNNNNNNNNNNNYNNYNNNNNNNNNNNNYNNYNNNNNNNNNNNNYNNYNNNNNNNNNNNNY
-----------------------------------------------------------------------------------
-----------------------------------------------------------------------------------
-----------------------------------------------------------------------------------
-------------------------------------------xxxxxxxxxxxxxxxxxxxxxxxxxxxxxxxxxxxxxxxx
------------SSSSSSSSSSSSSSSSSSSSSSSSSSSSSSSSSSSSSSSSSSSSSSSSSSSSSSSSSSSSSSSSSSSSSSS
----------------SSSSSSSSSS------------SSSS--SSSSSSSSSSSSSSSSSSSSSSSSSSSSSSSSSSSSSSS
----------oo----SSSSSSSSSS------------SSSS--SSSSSSSSSSSSSSSSSSSSSSSSSSSSSSSSSSSSSSS
---oo---oooS?--------S------?-------o-------SSSSSSSSSSSSSSSSSSSSSSSSSSSSSSSSSSSSSSS
--------oo----------------o?--------o-----oo---------------------------------------
-------o--o-------------ooS?--------S--oo------------------------------------------
------ooo--o----E--oo-Eo???-S---E--o---???SSooo----oo-ooooooooo----oo-ooooooooo----
------oo---S-?Q-SSSSSES?-----QQES-----SSS?--SS?SSSoSSESS?SS??S?SSSSSS-SS??S????SS-<
---------------E--E--S----E------E---------S------S--S------------S---------------[
-----B-E--E------ES-----E---------B---E-E-E---------------------------------------[
-xxxxxxxxxxxxxxxxxxxxxxxxxxxxxxxxxxxxxxxxxE----EEE----EE-EE----EEEE--EEE--E----EEE[
XXXXXXXXEXXXXXXXEXXXXXXXXXXXXXXXXXXXXXXXXXXXXXXXXXXXXXXXXXXXXXXXXXXXXXXXXXXXXXXXXXX
