NNNNNYYNNYYNNYYNNYYNNYYNNYYNNYYNNYYNNYYNNYYNNYYNNYYNNYYNNYYNNYYNNYYNNYYNNYYNNY
------------------------------------------------------------------------------
------------------------------------------------------------------------------
------------------------------------------------------------------------------
------------------------------------------------------------------------------
------------------------------------------------------------------------------
------------------------------------------------------------------------------
-------------------------------------------------------------XXX--------------
----------------------------------------------------------E--[]---------------
---------------------------------------------------------<>--[]---------------
---------------------------------------------------------[]--[]---------------
---------------------------------------------------------[]--[]----------<E---
------E---E-------------?--------------------------xxxxx-<X--<>----------[]--<
-----<>--<>-----------------xxxx------------------xx-<>-x----xxx---xxxxx-[]--[
---------------------------xx<>-x------------<-xxxx--[]--xxxxxE-xxxx-<>-x[]--[
-xxxxxxxxxxxxxxxxxxxxxxxxxxx-[]--xxxxxxxxxxxxxxx-<>--[]--XXXXXX-X<>E-[]--[]--[
XXXXXXXXXXXXX<>XX<>XX<>XX<>X-XXXX<>XX<>XX<>XXX>X-[]--XXXXXX-XXX-X[]XXXXXXXXXXX
