NNNNNYYNNYYNNYYNNYYNNYYNNYYNNYYNNYYNNYYNNYYNNYYNNYYNNYYNNYYNNYYNNYYNNYYNNYYNNY
------------------------------------------------------------------------------
------------------------------------------------------------------------------
------------------------------------------------------------------------------
------------------------------------------------------------------------------
------------------------------------------------------------------------------
------------------------------------------------------------------------------
------------------------------------------------------------------------------
------------------------------------------------------------------------------
------------------------------------------------------------------------------
-------------------------------------------------<E---E-----------------------
-------------------------------------------------[>--<>--<>-------E---E-------
------E--<>------<E------<E--<E------<---<E------[]--[]--[>--<>--<>--<>--<E---
-----<>--[]--<E--[>--<E--[>--[>--<E--[>--[>--<E--[]--[]--[]--[]--[]--[]--[>--<
---------[]--[>--[]--[>-E[]--[]--[]--[]--[]--[>--[]--[]--[]--[]--[]--[]--[]--[
-xxxxxxxx[]--X]--XX--X]-XXXXXXXXXX]--XXXXXXXXX]--XXXXXXXXXXXXXXXXXXXXXXXXXXXXX
XXXXXXXXXXXXXXXXXXXXXXXXXXXXXXXXXXXXXXXXXXXXXXXXXXXXXXXXXXXXXXXXXXXXXXXXXXXXXX
