NNNNNNNYYYYYYYYNNNNNNNNYYYYYYYYNNNNNNNNYYYYYYYYNNNNNNNNYYYYYYYYNNNNNNNNYYYYYYYYNNNN
NNNYYNYYYNNNNNNNNNNYYNYYYNNNNNNNNNNYYNYYYNNNNNNNNNNYYNYYYNNNNNNNNNNYYNYYYNNNNNNNNNN
NNNNNNNYYYYNNNNYYNNNNNNYYYYNNNNYYNNNNNNYYYYNNNNYYNNNNNNYYYYNNNNYYNNNNNNYYYYNNNNYYNN
NNNNNNYNNNYYNNNNYYNNNNYNNNYYNNNNYYNNNNYNNNYYNNNNYYNNNNYNNNYYNNNNYYNNNNYNNNYYNNNNYYN
NNNNNYNNNNNNNNNNNNYNNYNNNNNNNNNNNNYNNYNNNNNNNNNNNNYNNYNNNNNNNNNNNNYNNYNNNNNNNNNNNNY
-----------------------------------------------------------------------------------
-----------------------------------------------------------------------------------
-----------------------------------------------------------------------------------
-----------------------------------------------------------------------------------
-----------------------------------------------------------------------------------
-----------------------------------------------------------------------------------
-----------------------------------o------E--------oo-So-----------oo--E--E----E---
-------Q?QQQQQQ---------QQQQQQQX--SSo---QQQQQQQX-SSSSS--QSSSS-SSSSSSSSSQSSQQQQQXE--
-------------------------------XE--------------X-------------------------------XX--
---o----E----------------------XX--------------X-------------------------------XX--
----o--E-EEE-------oo---EEE----XXE-----?EEEE---XE----EEEE-E-----EE-----EE--E---XX--
------?Q-QQQQQQ-------QQQQQQQQQXXSSS--o?QQQQQQQXSEESSSS?QQQQQQQESSE---EQQQQQQQQXX--
--------------------------------------------------S---------------S--BE---------X--
---------------EE-B----E----------B--BEE-------E-------S-E-----------b-----------BB
-xxxxxxxxxxxxxxxxxxxxxxxxxxxxxxxxxxxxxxxxxxxxxxxxxxxxxxxxxxxxxxxxxxxxxxxxxxxxxxxExx
XXXXX<>XXXXXXXXX<>XXX<EXXXXXXXXXXXXXXXXXXXXXXXXXXXXXXXXXXXXXXXXXXXXXXXXXXEXXXXXXxXX
