NNNNNNNYYYYYYYYNNNNNNNNYYYYYYYYNNNNNNNNYYYYYYYYNNNNNNNNYYYYYYYYNNNNNNNNYYYYYYYYNNNN
NNNYYNYYYNNNNNNNNNNYYNYYYNNNNNNNNNNYYNYYYNNNNNNNNNNYYNYYYNNNNNNNNNNYYNYYYNNNNNNNNNN
NNNNNNNYYYYNNNNYYNNNNNNYYYYNNNNYYNNNNNNYYYYNNNNYYNNNNNNYYYYNNNNYYNNNNNNYYYYNNNNYYNN
NNNNNNYNNNYYNNNNYYNNNNYNNNYYNNNNYYNNNNYNNNYYNNNNYYNNNNYNNNYYNNNNYYNNNNYNNNYYNNNNYYN
NNNNNYNNNNNNNNNNNNYNNYNNNNNNNNNNNNYNNYNNNNNNNNNNNNYNNYNNNNNNNNNNNNYNNYNNNNNNNNNNNNY
-----------------------------------------------------------------------------------
-----------------------------------------------------------------------------------
-----------------------------------------------------------------------------------
-----------------------------------------------------------------------------------
-----------------------------------------------------------------------------------
-----------------------------------------------------------------------------------
-------------------oo-SoE-E-------------E---------------------------------EE-------
----------SSSSSSSSSSSS-SSSSSS-----------QQ?SQQQX-----------------------------------
-----------------------------------------------X-----------------------------------
-----------------------------------------------XE----------------------?-----------
---oo--?-?EE----EE---EE-E-E--------oo-o?E-EE---XE--------?Q------------?Q???-------
------oQQQQQQQQESSESSSS?Q?QQQQQ-E------E?QQQQQQX-E-----Q??-QQQQ--->-o-E-----??Q----
------------------S------------EE------------------>--?----------<]--->------------
-------EE-------------------------B------------E--<]-<--E-E-----E[]--<]EEE--------<
-xxxxxxxxxxxxxxxxxxxxxxxxxxxxxxxxxxxxxxxxxxxxxxx--[]o[-EXXXE---EEXXX-[XXXXXX---EEE[
XXXXX<>XXXXXXXXXXXXXXXXXXXXXXXXXXXXXX<>XXXXXXXXXX-XXXXXXXXXXXX-XXXXXXXXXXXXX---XXXX
