NNNNNYYNNYYNNYYNNYYNNYYNNYYNNYYNNYYNNYYNNYYNNYYNNYYNNYYNNYYNNYYNNYYNNYYNNYYNNY
------------------------------------------------------------------------------
------------------------------------------------------------------------------
------------------------------------------------------------------------------
------------------------------------------------------------------------------
------------------------------------------------------------------------------
------------------------------------------------------------------------------
--------------------------------------E---------------------------------------
------------------E---E-----------E--->-----------E---------------------------
-----------------<>--E>----------<>--<]----------<>----------------------<>---
-----------------[]--[]----------[]--[Q----------[]----------------------[]---
-----------------XXSS[]SS------?QQQQQQ-----------XX----------------------XX---
----------xxxxxx-----XX---------------------------X------<E---E-----xxxx---X--
--------xxx--<>-x-X------xxx-xxx-----------xxxxx-----<>--->--<>----xx<>-x-----
-----<>xx<>--[]--xxxxxxxxxE-xxE-xxxxxxxxxxxx-<>-x-----------------xx-[]--x----
-xxxxxxx-[]--[]--XXXXXXXX<>XX<>XXXXXXXXXX<>X-[]--xxxxxxxxxxxxxxxxxx--[]---xxxx
XXXXXXXXXXXXXXXXXXXXXXXXX[]XX[]XXXXXXXXXX[]X-XXXXXXXXXXXXXXXXXXXX<>--XXXXXXXX<
