NNNNNNNYYYYYYYYNNNNNNNNYYYYYYYYNNNNNNNNYYYYYYYYNNNNNNNNYYYYYYYYNNNNNNNNYYYYYYYYNNNN
NNNYYNYYYNNNNNNNNNNYYNYYYNNNNNNNNNNYYNYYYNNNNNNNNNNYYNYYYNNNNNNNNNNYYNYYYNNNNNNNNNN
NNNNNNNYYYYNNNNYYNNNNNNYYYYNNNNYYNNNNNNYYYYNNNNYYNNNNNNYYYYNNNNYYNNNNNNYYYYNNNNYYNN
NNNNNNYNNNYYNNNNYYNNNNYNNNYYNNNNYYNNNNYNNNYYNNNNYYNNNNYNNNYYNNNNYYNNNNYNNNYYNNNNYYN
NNNNNYNNNNNNNNNNNNYNNYNNNNNNNNNNNNYNNYNNNNNNNNNNNNYNNYNNNNNNNNNNNNYNNYNNNNNNNNNNNNY
-----------------------------------------------------------------------------------
-----------------------------------------------------------------------------------
-----------------------------------------------------------------------------------
-----------------------------------------------------------------------------------
-----------------------------------------------------------------------------------
-----------------------------------------------------------------------------------
----------o?------------QQo--??-----o---E?--------------E-E-------------E----------
--------ooQS?QQX-------?--SSS--xx--o---QQQ?QQQQX-X------SQQQQQQXE------QSS?QQQQX---
--------o?-----X------o-------xx-x-------------X-X-------------X---------------X---
---oo--oo------XE------?----xxx---x------------XEX-------------X---------------X---
------oo--E?---XE-------?S-xxSS----x---Q--E----XEX-oo--EE-EE---X-----BE-E-E----XE--
------oE--SSSSQX---o---xxxxQ?----<E-x-?-Q-QQQQQX-X----oSQ?QQQQQXE--oSbSQQQQQQQQXE--
--------E-------------x--?Q------[>--x------------B--------------E-----------------
-----B---------E-EBxxxxEE-------E[]---xx-------E-Eb--BEE-------E--B----E----------B
-xxxxxxxxxxxxxxxxxx--<>---E----EE[]---EExxxxxxxxxxxxxxxxxxxxxxxxxxxxxxxxxxxxxxxxxxx
XXXXXXXXXXXXXXXXXXX--[]--XXXXXXXXXXXX<>XXXXXXXXXXXXXXXXXXXXXXXXXXXXXXXXXXEXXXXXXXXX
