NNNNNNNYYYYYYYYNNNNNNNNYYYYYYYYNNNNNNNNYYYYYYYYNNNNNNNNYYYYYYYYNNNNNNNNYYYYYYYYNNN
NNNYYNYYYNNNNNNNNNNYYNYYYNNNNNNNNNNYYNYYYNNNNNNNNNNYYNYYYNNNNNNNNNNYYNYYYNNNNNNNNN
NNNNNNNYYYYNNNNYYNNNNNNYYYYNNNNYYNNNNNNYYYYNNNNYYNNNNNNYYYYNNNNYYNNNNNNYYYYNNNNYYN
NNNNNNYNNNYYNNNNYYNNNNYNNNYYNNNNYYNNNNYNNNYYNNNNYYNNNNYNNNYYNNNNYYNNNNYNNNYYNNNNYY
NNNNNYNNNNNNNNNNNNYNNYNNNNNNNNNNNNYNNYNNNNNNNNNNNNYNNYNNNNNNNNNNNNYNNYNNNNNNNNNNNN
----------------------------------------------------------------------------------
----------------------------------------------------------------------------------
----------------------------------------------------------------------------------
----------------------------------------------------------------------------------
----------------------------------------------------------------------------------
----------------------------------------------------------------------------------
-------------?-----------------E-----------------------?Q--E-----------??Q?Q------
--------------Q-------o??QQQQQQX-------??----------------Q<>----------E-E---Q?----
-------------------------------XE------------------oo-----[]-------oo-xxx---------
----------oo?---E--oo----------XX----------------------E--QX?QQ-----xxxE-xxxxx----
-------ooooQ-X---------?--EE---XX--------Q?QQQQ-E-----E?EE---------xx<>EEEEQ-xxx--
---oo-oooo----Q-----xxxx?QQQQQQXXE-oo-QQQ-----------xxxxx------xxxxx-[]-------Q-x-
-------ooEE--------xx---x------XX-B------------E---xx-E--x----xx--x--XX----------x
----xxxxxxxxxxxxxxxx-----x--------b------xxxxxxxxxxx--X---xxxxx--<>--------------<
-xxxx-EEEXXXXx-EE<>---E---xxxxxxExxxxxxxxEEEXXXXE<>-------XXXXXEE[]-------E----EE[
XXXXXE---------XX[]---XXXEXXXXXXxXXXX<EEEXXXXXXXX[]-------XXXXXXXXXXXX----------XX
