NNNNNNNYYYYYYYYNNNNNNNNYYYYYYYYNNNNNNNNYYYYYYYYNNNNNNNNYYYYYYYYNNNNNNNNYYYYYYYYNNNN
NNNYYNYYYNNNNNNNNNNYYNYYYNNNNNNNNNNYYNYYYNNNNNNNNNNYYNYYYNNNNNNNNNNYYNYYYNNNNNNNNNN
NNNNNNNYYYYNNNNYYNNNNNNYYYYNNNNYYNNNNNNYYYYNNNNYYNNNNNNYYYYNNNNYYNNNNNNYYYYNNNNYYNN
NNNNNNYNNNYYNNNNYYNNNNYNNNYYNNNNYYNNNNYNNNYYNNNNYYNNNNYNNNYYNNNNYYNNNNYNNNYYNNNNYYN
NNNNNYNNNNNNNNNNNNYNNYNNNNNNNNNNNNYNNYNNNNNNNNNNNNYNNYNNNNNNNNNNNNYNNYNNNNNNNNNNNNY
-----------------------------------------------------------------------------------
-----------------------------------------------------------------------------------
-----------------------------------------------------------------------------------
-----------------------------------------------------------------------------------
-----------------------------------------------------------------------------------
-----------------------------------------------------------------------------------
--------E------------------------------------------------------E-------oEEE--------
---oo--?QQQQQQQ---------?-QQQQQX----------?QQQQX--------QQ?QQQQX-------??QQQQQQX---
-------------------------------XE--oo----------X---------------X<E-------------X<E-
-------------------------------X---------------X---------------X[>-------------X[>-
-------E-EEE--------o--E-------XX------oo?E----XE-------EEE----X[]-------------X[]-
------EQQQQQQQQ----o--oQQ?QQQQQXX<----ooQ-QQQQQX<--oo-Q?QQQQQQQXXX-QSxxx-SQQQQQXXXX
------S---------E-----E---------------------------B-----------------xx--x----------
-----------------EB--B---------E-----BEEE------E--b----------------xx----x-----E---
-xxxxxxxxxxxxxxxxxxxxxxxxxxxxxxxxxxxxxxxxxxxxxxxxxxxxxxxxxxxxxxxxxxx-EEE--xxxxxxxxx
XXXXXXXXXXXXXXXXXXXXXXXEEEEXXXXXXXXXXXXXXXXXXXXXXXXXX<<EXXXXXXXXXX<>--EXXXXXXXXXXXX
