NNNNNYYNNYYNNYYNNYYNNYYNNYYNNYYNNYYNNYYNNYYNNYYNNYYNNYYNNYYNNYYNNYYNNYYNNYYNNY
------------------------------------------------------------------------------
------------------------------------------------------------------------------
------------------------------------------------------------------------------
------------------------------------------------------------------------------
------------------------------------------------------------------------------
------------------------------------------------------------------------------
------------------------------------------------------------------------------
---------------------<E-------------------------------------------------------
---------------------[>-----------------------------------------------E-------
--------------E------[]----------------------------------------------<>---E---
------E---E--<>------XXX------------------------xxxx-----------------[]--<>---
-----<>--->--[]--------------------------------xx<>-x-----------xxxx-[]--[]--<
---------<---X----xxxx------------------------xx-[]--xxx-------xx<>-x[]--[]--[
----------------xxx---x--<E----------------xxxx--[]--<>-x---xxxx-[]--[]--[]-E[
-xxxxxxxxxxxxxxxx<>----xxxxxxxxxxxxxxxxxxxxx-<>--[]--[]--xxxx<>XXXXXXXXXXXXXXX
XXXXXXXXXXXXXXXXX[]--XXXXX>XX<>XX<>XX<>XX<>X-[]--XXXXXXXX<>XX[]XXXXXXXXXXXXXXX
