NNNNNNNYYYYYYYYNNNNNNNNYYYYYYYYNNNNNNNNYYYYYYYYNNNNNNNNYYYYYYYYNNNNNNNNYYYYYYYYNNNN
NNNYYNYYYNNNNNNNNNNYYNYYYNNNNNNNNNNYYNYYYNNNNNNNNNNYYNYYYNNNNNNNNNNYYNYYYNNNNNNNNNN
NNNNNNNYYYYNNNNYYNNNNNNYYYYNNNNYYNNNNNNYYYYNNNNYYNNNNNNYYYYNNNNYYNNNNNNYYYYNNNNYYNN
NNNNNNYNNNYYNNNNYYNNNNYNNNYYNNNNYYNNNNYNNNYYNNNNYYNNNNYNNNYYNNNNYYNNNNYNNNYYNNNNYYN
NNNNNYNNNNNNNNNNNNYNNYNNNNNNNNNNNNYNNYNNNNNNNNNNNNYNNYNNNNNNNNNNNNYNNYNNNNNNNNNNNNY
-----------------------------------------------------------------------------------
-----------------------------------------------------------------------------------
-----------------------------------------------------------------------------------
-----------------------------------------------------------------------------------
-----------------------------------------------------------------------------------
-----------------------------------------------------------------------------------
----------------------oQQ-QQQ-----------------------------E----E-------------------
----------------------X--Q<]-----X-------QQQQQQXXSSS----QQQQQQQX-----------QQQQX---
-------------------oo-----[]----<>-------------X[---o----------X<>-------------X---
---oo--oQ-----------------[]----[]--------E----X[--------------X[]-----o-------XE--
-------o?Q?QQQQ-E------E--<>----X>-----o?--E---X[E--SBoEEEEE---XX]--o--o?QE----X---
------o-------------xxxxE----Q?E---Qo-oo?Q?QQQQX[SSo-bS??QQQQQQX---o--o-?-QQQQQX---
------E---E----EE--xx--Exxxxx----------E----------E--------------------E-----------
-----Bxxxxxxxxxxxxxx--->EExE-x-------BEEE------EE-----------------B--BExxx-----E---
-xxxxx-EXXXEXXXXX<>----]XX<>--xxxxxxxxxxxxxxxxxxxxxxxxxxxxxxxxxxxxxxxxxxXXxxxxxxxxx
XXXXXX--XXXXXXXXX[]-----XX[]--XXXX<XXXXXXXXXXXXXXXXXXXEXXXXXXXXXXXXXXX----XXXXXXX<>
