NNNNNYYNNYYNNYYNNYYNNYYNNYYNNYYNNYYNNYYNNYYNNYYNNYYNNYYNNYYNNYYNNYYNNYYNNYYNNY
------------------------------------------------------------------------------
------------------------------------------------------------------------------
------------------------------------------------------------------------------
------------------------------------------------------------------------------
------------------------------------------------------------------------------
------------------------------------------------------------------------------
-----------------------------------------------------------------------------x
--------S-E-------------------E--------------------------------------------xxx
---------[>------------------<>-------------------------------------------xxXX
---------[]------------------[]-------------------------------xxxx------xxx-X[
---------XX---E--------------XX-----------------o---------xxxxx---xx---xx<>-X[
----------X--<>----------------X------E-----------------xxx--<>--<>-x-xx-[]-X[
------E-----------------xxxx---------<>---E------------xx<>--[]--[]--xx--[]-X[
-----<>----------------xx<>-x------------<>---xxxxxxx-xx-[]--[]--[]--<>--[]-X[
-xxxxxxxxxxxxxxxxxxxxxxxE[]--xxxxxxxxxxxxxxxxxx--<>X-xx--[]--[]--[]--[]--[]-XX
XXXXXXXXXXXXXXXXX<>XX<>XXXXXXXXXX<>XXXXXXXXXX<>--[]XX<>--XXXXXXXXXXXXXXXXXXXXX
