NNNNNNNYYYYYYYYNNNNNNNNYYYYYYYYNNNNNNNNYYYYYYYYNNNNNNNNYYYYYYYYNNNNNNNNYYYYYYYYNNN
NNNYYNYYYNNNNNNNNNNYYNYYYNNNNNNNNNNYYNYYYNNNNNNNNNNYYNYYYNNNNNNNNNNYYNYYYNNNNNNNNN
NNNNNNNYYYYNNNNYYNNNNNNYYYYNNNNYYNNNNNNYYYYNNNNYYNNNNNNYYYYNNNNYYNNNNNNYYYYNNNNYYN
NNNNNNYNNNYYNNNNYYNNNNYNNNYYNNNNYYNNNNYNNNYYNNNNYYNNNNYNNNYYNNNNYYNNNNYNNNYYNNNNYY
NNNNNYNNNNNNNNNNNNYNNYNNNNNNNNNNNNYNNYNNNNNNNNNNNNYNNYNNNNNNNNNNNNYNNYNNNNNNNNNNNN
----------------------------------------------------------------------------------
----------------------------------------------------------------------------------
----------------------------------------------------------------------------------
----------------------------------------------------------------------------------
----------------------------------------------------------------------------------
----------------------------------------------------------------------------------
--------------------------------------------------------E?Q?-??E---------------E--
-------Q?Q?QQQQX-------QQQQQQQQE--------------------o--QQ---?-----------QQ?QQQQXE-
---------------XE---------------E------------------o---------------------------XX-
---------------XX---------------X------?-------------------xxxxx---oo--E-------XX-
---oo---E-?E---XX---------EE----X---o-o?QQQQQQQ-----xxxxxxx<-SS-x-----o?E-E----XX-
------QQQQ-QQQQXX<-oo-?QQSQQQQQ-X--o---------------xx-----?[-----x------QQQQQQQXXE
--------------------------------X---------E----EE-xx-------[------xx--E---------X-
---------------E----------------E-B-xxxxxxxxxxxxxxx--------[-----<>-x-------------
-xxxxxxxxxxxxxxxxxxxxxxxxxxxxxxxxxxxx-EEEE-EXXXXE<>--EEEEEE[----E[]--xxxxxxxxxxxxx
XXXXX<EEXXXXXXXXXXXXX<>EEEXXXXXXXXXXX--XXXXXXXXXX[]--XXXXXXX----XXXXXEXXXXXXXXXXXX
