NNNYYNNYYNNYYNNYYNNYYNNYYNNYYNNYYNNYYNNYYNNYYNNYYNNYYNNYYNNYYNNYYNNYYNNYYNNYYN
------------------------------------------------------------------------------
------------------------------------------------------------------------------
------------------------------------------------------------------------------
------------------------------------------------------------------------------
-----------------------------------------------------SSSSSSS------------------
----------------------------------------------------------SS------------------
-----------------------------------------------------------S------------------
-----------------------------------------------------------S--------------<E--
-----------------------------------E--------------------------------------[>--
-------E---E-------E--------------<>---E-------E--------------------------[]--
------<>--<>------<>--X--------E--[]--<>------<>-------E------------------[]--
------[]--[]--<>--[]--XX--<E--<>--[]--[]S-<>--[]---E--<>--QS--<E--<>---QQQ[]X-
------X]--[]--[]--[]------[>--[]--[]--[]--[]--[]--<>--[]--SS--[>--[]------XX--
-----E-X--[]--[]--[]------[]--[]---]--[]--b]--[]--[]--[]--SS--[]--[]----------
-xxxxxxX--[]--XXXXXXX-----XXXXXXXXXXXXXXXXXXXXXX--[]--[]--SS--XX--[]--<>------
XXXXXXXX--XX--XXXXXXX-----XXXXXXXXXXXXXXXXXXXXXX--XX-XXXXXXX--XX--XXXX[>-<XX--
