NNNYYNNYYNNYYNNYYNNYYNNYYNNYYNNYYNNYYNNYYNNYYNNYYNNYYNNYYNNYYNNYYNNYYNNYYNNYYN
------------------------------------------------------------------------------
------------------------------------------------------------------------------
------------------------------------------------------------------------------
------------------------------------------------------------------------------
------------------------------------------------------------------------------
------------------------------------------------------------------------------
-------------------xxxxxx---------------------E-------------------------------
---------------xxxxx--<>-x----------------------------------------------------
----------------x-<E--[]--xx-----------------------------------E--------------
--------------xx--[>--[]--<-x---------------------------------<>--------------
-------------xxX--[]--[]--[E-x----<>---------------E----------[]----<E--------
------------xx<>--[]--QX--[>-Exxx-[]--<>----------<>----------[]----[>--------
----------<xx-[]--X]---X--[]--<>-x[]--[]------<E--[]----------[]----[]--------
---------xxx--[]---X---X--[]--[]--[]--[]------[]--[]--<>--<>--XXX-<E[]--------
-xxxxxxxxxx>E-[]----------[]--[]--[XXXXX------X]--[]--[]--[]--XXXX[>XX---X<x--
XXXXXX<XXXXXXXXX------XX--XXXXXX--XXXXXX------XX--XXXXXXXXXX--XXXXX]XX----[>xx
