NNNYYNNYYNNYYNNYYNNYYNNYYNNYYNNYYNNYYNNYYNNYYNNYYNNYYNNYYNNYYNNYYNNYYNNYYNNYYN
------------------------------------------------------------------------------
------------------------------------------------------------------------------
------------------------------------------------------------------------------
----------------------------------------------------------------------?-------
------------------------------------------------------------------------------
---------------------------------------o--------------------------------------
------------------------------------------------------------------------------
--------------<E--------------XXX---------------------------------------------
--------------[>--------------------------------------------------------------
--------------[]-----------E-------------------E---E---E--<E------<E----------
--------------X]----------->-----------E---E--->--<>--<>--[>--<E--[>---E---E--
---------o<E---X?-Q-------<]------<E--<>--<>--<]--[]--[]--[]--[>--[]--<>--<>--
----------->-----QQQQ-------------->--[]--[]--[]--X]--[]--[]--[]--[]--[]--[]--
-----------]--x---<------------xxx-]--[]--[]--[]--[]--[]--[]--[]--[]--[]--[]--
-xxxxxxxxxxxxxxxxxxx-----xxxxxxx------XX--[XXX[]--XXXXXXXXXXXXXXXXXXXXXXXXXXXX
XXXXXX<XXXXXXXXXXXXXxxxxxxXXXXXX------XX--XXXXXX--XXXXXXXXXXXXXXXXXXXXXXXXXXXX
