NNNYYNNYYNNYYNNYYNNYYNNYYNNYYNNYYNNYYNNYYNNYYNNYYNNYYNNYYNNYYNNYYNNYYNNYYNNYYN
------------------------------------------------------------------------------
------------------------------------------------------------------------------
------------------------------------------------------------------------------
------------------------------------------------------------------------------
------------------------------------------------------------------------------
------------------------------------------------------------------------------
------------------------------------------------------------------------------
------------------------------------------------------<E------------------SE--
---------------------------------------------------x--[>------------------[>--
--------------------------------------------xxxxxxxxx-X]------------------[]--
-------xxx--------------X----------------xxxxxX---<E-x-X------------S-----[]--
-----xxx--xxxx--------<>---------------xxx<>--X]--[>---------xxxx----S----<]--
----xx<>--<>--xx------[]-------E-----xxxx-[]--<]--[]--x-----xx<>-xo---QS--[]--
---xx-[]--[]--<>x-----X]--<>-E<>---Exx<>--[]--[]--[]---x---xx-[]--xxxx----<]--
-xxx--[]--[]--[]-xxxxx[X--[]<>[]--<xx-[]--[]--XXX-[]----x-xx--[]--<>--xxxxxXXX
XXXXX-XX--[]--[]-XXXXXXX--[X[][XXX[>XXXX-XXXXXXXX-XX----XxxEXXXXXX[]EXXXXXXXXX
