NNNYYNNYYNNYYNNYYNNYYNNYYNNYYNNYYNNYYNNYYNNYYNNYYNNYYNNYYNNYYNNYYNNYYNNYYNNYYN
------------------------------------------------------------------------------
------------------------------------------------------------------------------
------------------------------------------------------------------------------
------------------------------------------------------------------------------
------------------------------------------------------------------------------
------------------------------------------------------------------------------
------------------------------------------------------------------------------
------------------------------------------------------------------------------
------------------E-----------------------------------------------------------
------------------X-----------------------------------------------------------
------------------X---------------------------<E-----------------------E------
-----xxxxxxxxxxx-QX----xxxxx-------E------<>--[>----------<E----------<>------
----xx<>--<>-<>-x-X--xxEx-<>x-----<>------[]--[]------<>--[>--<E--<>--[]------
---xx-[]--[]-[]--x--xx<>--[]-x----[]--<>--[]--[]--<>--[]--[]--[>--[]--[]------
-xxx--[]--[]-[]----xx-[]--[]--xx--[]--[]E-[]--X]--[]--[]--XXXX[]--[]--[]--<>--
XXXXXXXXXXXXXXXXXXxx--[]--[]--<>xx[XXXXXXXXX--XXXX[]--XX--XXXXXXXXXXXXXXXX[>--
