NNNYYNNYYNNYYNNYYNNYYNNYYNNYYNNYYNNYYNNYYNNYYNNYYNNYYNNYYNNYYNNYYNNYYNNYYNNYYN
------------------------------------------------------------------------------
------------------------------------------------------------------------------
------------------------------------------------------------------------------
------------------------------------------------------------------------------
------------------------------------------------------------------------------
-------------------------------E----------------------------------------------
------------------------------------------------------------------------------
------------------------------------------------------------------------------
---------------------------E--------------------------------------------------
-------E------<E----------------------------------------------------------<E--
------<>------[>----------<>----------------------------------<E----------[>--
------[]S--E--[]--<E------[]-----------ESSQ------------E------[>----------[]--
------[]--<>--[]--[>--<E--[]--<E------<>------<---<>--<>--<E--[]------<E--[]--
------XX--[]--[]--[]--[>--[]--[>--<>--[]------[>--[]--[]--[>--[]--<>--[>--[]--
-xxxxx-xx-[]--[]--[]--[]--[]--[]--[]--[]--<---[]--[]--[]--X]--X]--[]--[]--[]--
XXXXXXxXXxXX--XX--XX--XX--XX--XXXXXXXXXX-X[>--XX-XXX--XX--XX--XX-XXX--XXXXXX--
