NNNNNNNNNNNNNNNNNNN
NNNNNYYNNYYNNYYNNYY
NNNNNNNNNNNNNNNNNNN
NNNNNNNNNNNNNNNNNNN
NNNNNNNNNNNNNNNNNNN
-------------------
-------------------
-------------------
-------------------
-------------------
-------------------
---------oo--------
-------------------
------------------o
-------------oo--ox
-----oo------oo--xx
-------xxx------xx-
------xx--xxxxxxx--
-----xx---XXXXXXX--
-xxxxx----------X--
XXXXXX----------X--
