NNNNNNNNNNNNNNNNNNN
NNNNNYYNNYYNNYYNNYY
NNNNNNNNNNNNNNNNNNN
NNNNNNNNNNNNNNNNNNN
NNNNNNNNNNNNNNNNNNN
-------------------
-------------------
-------------------
-------------------
-------------------
-------------------
-----------------oo
-------------------
-------------------
-------------------
-----oo--oo--oxxxx-
-------------xx---x
------------xx----X
-----------xx------
-xxxxxxxxxxx--o----
XXXXXXXXXXXXXXX----
