NNNNNNNNNNNNNNNNNNN
NNNNNYYNNYYNNYYNNYY
NNNNNNNNNNNNNNNNNNN
NNNNNNNNNNNNNNNNNNN
NNNNNNNNNNNNNNNNNNN
-------------------
-------------------
-------------------
-------------------
-------------------
-------------------
-----------------oo
------------------x
-----------------xx
----------------xx-
-----oo--oo--xxxx--
------------xx-XX--
-----------xxS-----
----------xx-------
-xxxxxxxxxx--oo----
XXXXXXXXXXXXXXX----
