NNNNNNNNNNNNNNNNNNN
NNNNNYYNNYYNNYYNNYY
NNNNNNNNNNNNNNNNNNN
NNNNNNNNNNNNNNNNNNN
NNNNNNNNNNNNNNNNNNN
-------------------
-------------------
-------------------
-------------------
-------------------
-------------------
-------------------
-------------------
-------------o-----
-------------------
------o-------o--ox
-----o---oo------xx
----------------xx-
---------------xx--
-xxxxxxxxxxxxxxx--o
XXXXXXXXXXXXXXXXXXX
