NNNNNNNNNNNNNNNNNNN
NNNNNYYNNYYNNYYNNYY
NNNNNNNNNNNNNNNNNNN
NNNNNNNNNNNNNNNNNNN
NNNNNNNNNNNNNNNNNNN
-------------------
-------------------
-------------------
-------------------
-------------------
-------------------
-------------------
-------------------
-------------------
-------------oo--oo
-----oo--o---------
----------o--------
-------------------
-------------------
-xxxxxxxxxxxxxxxxxx
XXXXXXXXXXXXXXXXXXX
