NNNNNNNNNNNNNNNNNNN
NNNNNYYNNYYNNYYNNYY
NNNNNNNNNNNNNNNNNNN
NNNNNNNNNNNNNNNNNNN
NNNNNNNNNNNNNNNNNNN
-------------------
-------------------
-------------------
-------------------
-------------------
-------------------
-------------oo--oo
----------o--------
---------o---------
-------------------
----------xxxx----X
------o--xx---xxxx-
-----o--xx----XXX-x
-------xx----------
-xxxxxxxX----------
XXXXXXXXX----------
