NNNNNNNNNNNNNNNNNNN
NNNNNYYNNYYNNYYNNYY
NNNNNNNNNNNNNNNNNNN
NNNNNNNNNNNNNNNNNNN
NNNNNNNNNNNNNNNNNNN
-------------------
-------------------
-------------------
-------------------
-------------------
-------------------
-----------------oo
-------------------
-----oo-------o----
-------------o-----
---------oo---xxxx-
-------------xx---x
------------xx----X
-----------xx------
-xxxxxxxxxxxX------
XXXXXXXXXXXXX------
