NNNNNNNNNNNNNNNNNNN
NNNNNYYNNYYNNYYNNYY
NNNNNNNNNNNNNNNNNNN
NNNNNNNNNNNNNNNNNNN
NNNNNNNNNNNNNNNNNNN
-------------------
-------------------
-------------------
-------------------
-------------------
-------------------
-------------oo----
-------------------
----------o------oo
---------o-------oo
-----oo---xxxx-----
---------xx---xxxxx
--------xx----XXXX-
-------xx----------
-xxxxxxxX----------
XXXXXXXXX----------
