NNNNNNNNNNNNNNNNNNN
NNNNNYYNNYYNNYYNNYY
NNNNNNNNNNNNNNNNNNN
NNNNNNNNNNNNNNNNNNN
NNNNNNNNNNNNNNNNNNN
-------------------
-------------------
-------------------
-------------------
-------------------
-------------------
-------------------
-------------------
-------------------
-------------------
---------oo--oo--xx
-----oo---------xx-
---------------xx--
--------------xx---
-xxxxxxxxxxxxxx--oo
XXXXXXXXXXXXXXXXXXX
