NNNNNNNNNNNNNNNNNNN
NNNNNYYNNYYNNYYNNYY
NNNNNNNNNNNNNNNNNNN
NNNNNNNNNNNNNNNNNNN
NNNNNNNNNNNNNNNNNNN
-------------------
-------------------
-------------------
-------------------
-------------------
-------------------
-------------------
-------------------
-------------------
-------------------
------o--oo------oo
-----o-------oo----
-------------------
-------------------
-xxxxxxxxxxxxxxxxxx
XXXXXXXXXXXXXXXXXXX
