NNNNNNNYYNNNNNNYYNNNNNNNNNNNNNNNNNNYYNNNNNNYYNNYYNNNNNNNNNNNNNNNNNNNNNNYYNNNNNNYYNNYYNNNNNNYYNNNNNNNNNNNNNNNNNNYYNNYYNNNNNNNNNNNNNNNNNNNNNNNNNNNNNNNNNNYYNNNNNNNNN
NNNNNNNNNNNNNNNNNNNNNNNYYNNNNNNNNNNNNNNNNNNNNNNNNNNYYNNNNNNNNNNYYNNNNNNNNNNNNNNNNNNNNNNNNNNNNNNYYNNYYNNNNNNNNNNNNNNNNNNNNNNYYNNNNNNNNNNYYNNNNNNNNNNNNNNNNNNNNNNNNN
NNNYYNNNNNNNNNNNNNNYYNNNNNNNNNNYYNNNNNNNNNNNNNNNNNNNNNNNNNNNNNNNNNNYYNNNNNNNNNNNNNNNNNNYYNNNNNNNNNNNNNNNNNNNNNNNNNNNNNNYYNNNNNNNNNNNNNNNNNNNNNNYYNNYYNNNNNNNNNNNNN
NNNNNNNNNNNNNNNNNNNNNNNNNNNYYNNNNNNNNNNYYNNNNNNNNNNNNNNYYNNYYNNNNNNNNNNNNNNNNNNNNNNNNNNNNNNNNNNNNNNNNNNYYNNNNNNNNNNNNNNNNNNNNNNNNNNYYNNNNNNYYNNNNNNNNNNNNNNNNNNYYN
NNNNNNNNNNNYYNNNNNNNNNNNNNNNNNNNNNNNNNNNNNNNNNNNNNNNNNNNNNNNNNNNNNNNNNNNNNNYYNNNNNNNNNNNNNNNNNNNNNNNNNNNNNNYYNNNNNNNNNNNNNNNNNNYYNNNNNNNNNNNNNNNNNNNNNNNNNNYYNNNNN
------------------------------------------------------------------------------------------------------------------------------------------------------------------
------------------------------------------------------------------------------------------------------------------------------------------------------------------
------------------------------------------------------------------------------------------------------------------------------------------------------------------
------------------------------xx----------------------------------------------------------------------------------------------------------------------------------
-----------------------------xx-xx----xx-------------------------------------------------------oo-----------------------------------------------------------------
----------------------------xx----x--xx-x-------------------------------------------------------XX----------------------------------------------------------------
----------------------------x------xxx---x------Q----------------------------------------------X----o-------------------------------------------------------------
--------Q--------------oo--xx------?QS----x?Q--?-------------------------------QQ--------------X---o------------Q---?-----------------------------------?---------
-------------------E------xxE--------------x-------------------------------------------------------------------------------oo----------oo----------------------<>-
-----------xxxxxxxxxxxxxxxx<>---------------xxxxxx-oo-----------o---------------------------------------------xxxxxxxx-----------------------------------------[]-
-------xxxxx<>-xQ--------xX[]------------------SS-x-o----------o---------------------------?-----xxx---------xx?xx-?S-x-----------------------------xxx--------[]-
------xxQ-XB[]-?---------XX[]------?QS-------------x-------------------?Q------QQ--Q?-------?---xx--xxxxxxx-xx--Q------x--------xxx----------------xx>-xx-------X-
---EExx?--X[[]-----------XX[]----------<>-----------x-----------------------B----------xxxxx---xx---XXXE<>-xx-----------x-----xxx--xxx---------E--xx<]-?-x--------
----xx----X[[]------E---XXX[]---->-----[]------------x-----------xxxxx-----Bb-----xxx-xx----x-xx--------[]-<>------------xx--xx<>--<>-x---------ExxE[]----xBB-----
-xxxx-----X[[XXXXXXXXXXXXXXXXXXE<]-----[]---?--XXXXX--xxxxxxxxxxxx-EE-xxxxxxxxxxxxx--xxEE----xx---------[]-[]--S-------EEX-xxx-[]--[]--xxxxxxxxxxx-X[]-----xxxxxxx
XXXXXXXXXXXXXXXXXXXXXXXXXXXXXXXX[XXXXXXXXXXXXXXXXXXXXXX<>XX<>XXXXX--XXXXXXXXXXXXXXXXXXXXXXXXXXX---------XXXXXXXXXXXXXXXXXXXXXXXXXXXXXXXXXXX<>XXXXX-XXXXXXXXXXXXXXX
