NNNNNNNNNNNNNNNNNNN
NNNNNNNNNNNNNNNNNNN
NNNNNYYNNYYNNYYNNYY
NNNNNNNNNNNNNNNNNNN
NNNYYNNYYNNYYNNYYNN
-------------------
-------------------
-------------------
-------------------
-------------------
-------------------
-------------------
-------------------
-------------------
-------------------
-------------------
------E<----------E
-----E-b--E--EE-B-E
---BB----E-BB--BbE-
-xxxxxxxxxxxxxxxxxx
XXXXXXXXXXXXXXXXXXX
