NNNNNNNNNNNNNNNNNNN
NNNNNNNNNNNNNNNNNNN
NNNNNYYNNYYNNYYNNYY
NNNNNNNNNNNNNNNNNNN
NNNYYNNYYNNYYNNYYNN
-------------------
-------------------
-------------------
-------------------
-------------------
-------------------
-------------------
-------------------
-------------------
-------------------
-------------------
------o------------
-----E---Exxxx---Ex
---BB--BBxxBB-xBBxx
-xxxxxxxxxEbbEExxxE
XXXXXXXXXXXXXXXXXXX
