NNNNNNNNNNNNNNNNNNN
NNNNNNNNNNNNNNNNNNN
NNNNNYYNNYYNNYYNNYY
NNNNNNNNNNNNNNNNNNN
NNNYYNNYYNNYYNNYYNN
-------------------
-------------------
-------------------
-------------------
-------------------
-------------------
-------------------
-------------------
-------------------
-------------------
-------------------
-----------B-----ES
---B---B---bBEE----
---bBE-bBE-Bb--BB-E
-xxxxxxxxxxxxxxxxxx
XXXXX-XXX-XXXXXXXXX
