NNNNNNNNNNNNNNNNNNN
NNNNNNNNNNNNNNNNNNN
NNNNNYYNNYYNNYYNNYY
NNNNNNNNNNNNNNNNNNN
NNNYYNNYYNNYYNNYYNN
-------------------
-------------------
-------------------
-------------------
-------------------
-------------------
-------------------
-------------------
-------------------
-------------------
-------------------
---------EE--------
----B-E-B----Exxxx-
---BbE-Bb--BBxxBB-x
-xxxxxxxxxxxxxEbbEE
XXXXXXXXXXXXXXXXXXX
