NNNNNNNNNNNNNNNNNNN
NNNNNNNNNNNNNNNNNNN
NNNNNYYNNYYNNYYNNYY
NNNNNNNNNNNNNNNNNNN
NNNYYNNYYNNYYNNYYNN
-------------------
-------------------
-------------------
-------------------
-------------------
-------------------
-------------------
-------------------
-------------------
-------------------
-------------------
-----E-------------
---B----B----------
---bBxxxxxxxxxxxxxx
-xxxxxEBXEEBBEEBBEE
XXXXXXXXXXXXXXXXXXX
