NNNNNNNNNNNNNNNNNNN
NNNNNNNNNNNNNNNNNNN
NNNNNYYNNYYNNYYNNYY
NNNNNNNNNNNNNNNNNNN
NNNYYNNYYNNYYNNYYNN
-------------------
-------------------
-------------------
-------------------
-------------------
-------------------
-------------------
-------------------
-------------------
-------------------
-------------------
-------------------
---B-E--<-E--Exxxx-
---bB--Bb--BBxxBB-x
-xxxxxxxxxxxxxEbbEE
XXXXXXXXXXXXXXXXXXX
