NNNNNNNNNNNNNNNNNNN
NNNNNNNNNNNNNNNNNNN
NNNNNYYNNYYNNYYNNYY
NNNNNNNNNNNNNNNNNNN
NNNYYNNYYNNYYNNYYNN
-------------------
-------------------
-------------------
-------------------
-------------------
-------------------
-------------------
-------------------
-------------------
-------------------
-------------------
------E------------
----BE-B-E-B-------
---Bb--bB-xxxxxxxxx
-xxxxxxxxxxBBEEBBEE
XXXXXXXXXXXXXXXXXXX
