NNNNNNNNNNNNNNNNNNN
NNNNNNNNNNNNNNNNNNN
NNNNNYYNNYYNNYYNNYY
NNNNNNNNNNNNNNNNNNN
NNNYYNNYYNNYYNNYYNN
-------------------
-------------------
-------------------
-------------------
-------------------
-------------------
-------------------
-------------------
-------------------
-------------------
-------------------
------------------E
-----EE---EB-E---E-
---BB--BBE-bB--BB--
-xxxxxxxxxxxxxxxxxx
XXXXXXXXXXXXXXXXXXX
