NNNNNNNNNNNNNNNNNNN
NNNNNNNNNNNNNNNNNNN
NNNNNYYNNYYNNYYNNYY
NNNNNNNNNNNNNNNNNNN
NNNYYNNYYNNYYNNYYNN
-------------------
-------------------
-------------------
-------------------
-------------------
-------------------
-------------------
-------------------
-------------------
-------------------
------------------x
------E--EE---xxxxx
---BBE-------x-----
---bb--BBxxxx>--E--
-xxxxxxxxx-E<]E<>EE
XXXXXXXXXX--[]XXXXX
