NNNNNNNNNNNNNNNNNNN
NNNNNNNNNNNNNNNNNNN
NNNNNYYNNYYNNYYNNYY
NNNNNNNNNNNNNNNNNNN
NNNYYNNYYNNYYNNYYNN
-------------------
-------------------
-------------------
-------------------
-------------------
-------------------
-------------------
-------------------
-------------------
-------------------
-------------------
--------------E----
----B-EB-E---E-----
---BbE-bB--BB-xxxxx
-xxxxxxxxxxxxxxBBEE
XXXXXXXXXXXXXXXXXXX
