NNNNNNNYYNNNNNNNNNNNNNNYYNNNNNNNNNNNNNNNNNNNNNNNNNNNNNNNNNNNNNNYYNNNNNNNNNNNNNNNNNNNNNNNNNNNNNNNNNNNNNNNNNNNNNNNNNNNNNNNNNNYYNNNNNNNNNNNNNNNNNNNNNNYYNNNNNNNNNNNNN
NNNNNNNNNNNNNNNYYNNYYNNNNNNYYNNNNNNYYNNNNNNNNNNNNNNNNNNNNNNNNNNNNNNNNNNYYNNNNNNYYNNYYNNNNNNNNNNYYNNYYNNNNNNYYNNYYNNNNNNNNNNNNNNNNNNNNNNYYNNNNNNYYNNNNNNNNNNNNNNNNN
NNNNNNNNNNNNNNNNNNNNNNNNNNNNNNNNNNNNNNNNNNNNNNNNNNNNNNNNNNNYYNNNNNNNNNNNNNNNNNNNNNNNNNNNNNNNNNNNNNNNNNNNNNNNNNNNNNNNNNNNNNNNNNNNNNNNNNNNNNNNNNNNNNNNNNNNNNNNNNNNNN
NNNYYNNNNNNYYNNNNNNNNNNNNNNNNNNNNNNNNNNYYNNYYNNYYNNYYNNNNNNNNNNNNNNYYNNNNNNYYNNNNNNNNNNYYNNNNNNNNNNNNNNYYNNNNNNNNNNYYNNYYNNNNNNNNNNNNNNNNNNNNNNNNNNNNNNYYNNYYNNYYN
NNNNNNNNNNNNNNNNNNNNNNNNNNNNNNNYYNNNNNNNNNNNNNNNNNNNNNNYYNNNNNNNNNNNNNNNNNNNNNNNNNNNNNNNNNNYYNNNNNNNNNNNNNNNNNNNNNNNNNNNNNNNNNNYYNNYYNNNNNNYYNNNNNNNNNNNNNNNNNNNNN
------------------------------------------------------------------------------------------------------------------------------------------------------------------
------------------------------------------------------------------------------------------------------------------------------------------------------------------
------------------------------------------------------------------------------------------------------------------------------------------------------------------
------------------------------------------------------------------------------------------------------------------------------------------------------------------
----------------------------------------------------------------------------------------------------o----------o--------------------------------------------------
-------------------oo------------------------------------------------------------------------------------------oo-------------------------------------------------
-------------------XX-------------------------xx-----xxx-------------------------------------------oXX------o---o---------------------------------------------xxxx
--------?S--------X--------------------------xx-xxxxxx--x---------------o--------------------------XX------oo------------xxxx------------------oo---Q--------xx<>-
---------------oo----------oo---------------xx------x----x-------------o-----------xxx----------------------------------xx---x------------------------------xx-[]-
------------------------------------------xxx------<>-----x---------------------xxxx--x-xxxxxx----------xxxxx-----------x-----x--------oo----------?----xxxxx--[]-
-----------------------?-----------oo----xx<>------[]------x-------------------xx-XE?--xx--<>-xoo----xxxx----x--------xxx------xxx-----oo-------------xxx--<>--[]-
-------Q?S--------------Q---------------xx-[]--<---[]-------x--QQ--<----------xx?-XX---<>--[]--x----xx-<>-----x------xx<>--??--<>-x------------------xx<>--[]--[]X
--------------------------------------xxx--[]--[>--[]--<E----x---------------xxE--XX---[]--[]---x--xx--[]------x----xxX[]------[]--x-------B--------xx-[]--[]--[]X
--------------------xxx--------BB----xx<>--[]--[]--[]--[>-----x------------xxxXX--XX---[]--[]----xxx---[]-------xxxxxXX[]------[]---xxxxxxxxxxxxxxxxxX-[]--[]--[]X
-xxxxxxxxxxxxxxxxxxxx--xxxxxxxxxxxxxxx-[]--[]--[]-XXXXX[]--EE--xxxxxxxxxxxxx>XX---XX---[]--[]-----x----[]-------X--x>XX[]------[]--B<>XXXXXXBXXXXXXXXX-[]--[]--[]X
XXX<>XXXXXX<>XXXXXXXX--XXXXXXXXXXXXXXXXXXXXXXXXXXXXXXXXXXXXXXXXXXXXXXXXXXXX<]XXXXXXX---XXXXXXX-XXXX----[]--------XX<]XXXXXXX---XXXXX[]XXXXXXXXXXXXXXXX-XXXXXXXXXXX
