NNNNNYYNNYYNNYYNNYY
NNNNNNNNNNNNNNNNNNN
NNNYYNNYYNNYYNNYYNN
NNNNNNNNNNNNNNNNNNN
NNNNNNNNNNNNNNNNNNN
-------------------
-------------------
-------------------
-------------------
-------------------
-------------------
---------------EES-
-----QQXXXQX--QSS--
-----------[-------
-----------X-------
----E------X-Q---QQ
---E-QQ--?QXo------
-------------------
-----------E--xxxxx
-xxxxxxxxxxxxxx--XX
XXXXXXXX<XXXXXX--XX
