NNNNNYYNNYYNNYYNNYY
NNNNNNNNNNNNNNNNNNN
NNNYYNNYYNNYYNNYYNN
NNNNNNNNNNNNNNNNNNN
NNNNNNNNNNNNNNNNNNN
-------------------
-------------------
-------------------
-------------------
-------------------
-------------------
-------E-----------
-----QQXX----Q?X-QQ
----E--XX---X--X---
----X--XX------X---
---E---XX--E---X---
-----QQXXQQ--QQX-QQ
------------E---E--
--------E------E---
-xxxxxxxxxxxxxxxxxx
XXXXXXXXXXXXXXXXXXX
