NNNNNYYNNYYNNYYNNY
NNNNNNNNNNNNNNNNNN
NNNYYNNYYNNYYNNYYN
NNNNNNNNNNNNNNNNNN
NNNNNNNNNNNNNNNNNN
------------------
------------------
------------------
------------------
------------------
------------------
------------------
-----QQX-QQX-QQ<--
--------X--X---[EQ
-----------X---[>-
-----------XE--X]-
----EQQ--QQX-QQ-X-
---E---E---------Q
--------E--E------
-xxxxxxxxxxxxxxx--
XXXXXXXXXXXXXXXXxx
