NNNNNYYNNYYNNYYNNYY
NNNNNNNNNNNNNNNNNNN
NNNYYNNYYNNYYNNYYNN
NNNNNNNNNNNNNNNNNNN
NNNNNNNNNNNNNNNNNNN
-------------------
-------------------
-------------------
-------------------
-------------------
-------------------
-------------------
-----QQ<-Q---QQX-QS
-------[--X----X---
-------[E------X---
-------X-------X---
----EQQ-XX---QQXEQQ
-------------------
---E---E-------E---
-xxxxxxx--xxxxxxxxx
XXXXXXXXxxXEEXXXXXX
