NNNNNYYNNYYNNYYNNYY
NNNNNNNNNNNNNNNNNNN
NNNYYNNYYNNYYNNYYNN
NNNNNNNNNNNNNNNNNNN
NNNNNNNNNNNNNNNNNNN
-------------------
-------------------
-------------------
-------------------
-------------------
-------------------
-------------------
-----QQX-QQX-QQX-QQ
-------X---X---X---
-------X---X---X---
----E--X---X---X---
---E-QQXEQQXE?QXEQQ
-------------------
-------E---E---E---
-xxxxxxxxxxxxxxxxxx
XXXXXXXXXXXXXXXXXXX
