NNNNNYYNNYYNNYYNNYY
NNNNNNNNNNNNNNNNNNN
NNNYYNNYYNNYYNNYYNN
NNNNNNNNNNNNNNNNNNN
NNNNNNNNNNNNNNNNNNN
-------------------
-------------------
-------------------
-------------------
-------------------
-------------------
-------------------
---------QQX-------
-------------------
-------------------
-----QQEE----------
----o----QQ--QQEEQQ
---E--------E------
-----------E------x
-xxxxxxxxxxxxxxxxxx
XXXXXXXXXXXXXXXXXXX
