NNNNNYYNNYYNNYYNNYY
NNNNNNNNNNNNNNNNNNN
NNNYYNNYYNNYYNNYYNN
NNNNNNNNNNNNNNNNNNN
NNNNNNNNNNNNNNNNNNN
-------------------
-------------------
-------------------
-------------------
-------------------
-------------------
-------o-----------
-----QQXX----------
--------[?---------
--------[----------
----E---[-Q--Q?E-?Q
---E-QQ-XQ---------
---E---------------
-----------xxxxxxxx
-xxxxxxxxxxxEXXXEXX
XXXXXXXXXXXXXXXXXXX
