NNNNNYYNNYYNNYYNNYY
NNNNNNNNNNNNNNNNNNN
NNNYYNNYYNNYYNNYYNN
NNNNNNNNNNNNNNNNNNN
NNNNNNNNNNNNNNNNNNN
-------------------
-------------------
-------------------
-------------------
-------------------
-------------------
---------------E---
---------QQX-QQX---
-----------X---XX--
-----------X---XX--
-------EE--X---XX--
-----?Q--QQXEQQXXQQ
---------------XX--
----E------E-------
-xxxxxxxxxxxxxxxxxx
XXXEXXXXXXXXXXXXXXX
