NNNNNYYNNYYNNYYNNYY
NNNNNNNNNNNNNNNNNNN
NNNYYNNYYNNYYNNYYNN
NNNNNNNNNNNNNNNNNNN
NNNNNNNNNNNNNNNNNNN
-------------------
-------------------
-------------------
-------------------
-------------------
-------------------
-------E-------E---
-----QQX-----QQX---
-------XX------XX--
-------XX------X---
-------XX------X-o-
----EQQXXQQ-EQQXo-o
---E-------E-------
--------E----------
-xxxxxxxxxxxxxxxxxx
XXXXXXXXXXXXXXXXXXX
