NNNNNYYNNYYNNYYNNYY
NNNNNNNNNNNNNNNNNNN
NNNYYNNYYNNYYNNYYNN
NNNNNNNNNNNNNNNNNNN
NNNNNNNNNNNNNNNNNNN
-------------------
-------------------
-------------------
-------------------
-------------------
-------------------
-------------------
-----QQ------------
----X-------xxxx---
-----------xx---xxx
---E-----?xx--?----
---------xx--------
--------xx?--?-----
-------xx---E----oo
-xxxxxxxE--EX-XEEXX
XXXXEXXXXXXXX------
