NNNNNNNNNNNYYNNNNNNYYNNNNNNNNNNNNNNNNNNNNNNNNNNYYNNYYNNNNNNNNNNNNNNNNNNNNNNNNNNYYNNNNNNNNNNYYNNNNNNNNNNNNNNYYNNNNNNNNNNNNNNYYNNNNNNNNNNYYNNNNNNNNNNNNNNNNNNNNNNNNN
NNNYYNNNNNNNNNNNNNNNNNNNNNNNNNNNNNNNNNNNNNNNNNNNNNNNNNNNNNNNNNNNNNNNNNNNNNNNNNNNNNNNNNNNNNNNNNNNNNNNNNNNNNNNNNNNNNNNNNNNNNNNNNNNNNNYYNNNNNNYYNNYYNNNNNNYYNNYYNNNNN
NNNNNNNNNNNNNNNNNNNNNNNNNNNNNNNNNNNYYNNNNNNYYNNNNNNNNNNNNNNNNNNNNNNNNNNYYNNNNNNNNNNNNNNNNNNNNNNNNNNYYNNNNNNNNNNNNNNNNNNNNNNNNNNYYNNNNNNNNNNNNNNNNNNYYNNNNNNNNNNYYN
NNNNNNNNNNNNNNNYYNNNNNNNNNNYYNNNNNNNNNNYYNNNNNNNNNNNNNNYYNNYYNNNNNNNNNNNNNNYYNNNNNNNNNNNNNNNNNNNNNNNNNNYYNNNNNNYYNNNNNNNNNNNNNNNNNNNNNNNNNNNNNNNNNNNNNNNNNNNNNNNNN
NNNNNNNYYNNNNNNNNNNNNNNYYNNNNNNYYNNNNNNNNNNNNNNNNNNNNNNNNNNNNNNYYNNYYNNNNNNNNNNNNNNYYNNYYNNNNNNYYNNNNNNNNNNNNNNNNNNYYNNYYNNNNNNNNNNNNNNNNNNNNNNNNNNNNNNNNNNNNNNNNN
------------------------------------------------------------------------------------------------------------------------------------------------------------------
-------------------------xxx--------------------------------------------------------------------------------------------------------------------------------------
------------------------xx--x-------------------------------------------------------------------------------------------------------------------------------------
-----------------------xx------------xx-xxxxxx--------------------------------------------------------------------------------------------------------------------
----------------------xx-----xxxxxxxx--xxx----x------------------------------------------------------------------------------------oo--?-----------------xx-------
---------------------xx------>-x---xE---x--EEX-xxxxx-------------------------------------------------------------------------------XXXX-----------------xx-x------
----------------xxxxxx-----E<]XX---E---<>------?QXX-xx-------SSS----------------------------------------------------------------------------o----------xx---x-----
-----------?Q--xx--?QS------[]---------[]--------XX-?-x----------SSSSS-E------------------------------------Q------------------------------o----o-----xx---o-x----
----oX--------xx>-----------[X---------[]--------XX----xxx---------------------------------------------------------------------EX--------------oo----xxE------x---
---oX-----xxxxx<]----------------------[]--------XX----BB-xxxxxxxx-------------------------------------------------------------X-----------------xxxx-X--------x--
---------xxSxx-[]----------------------[]--------XX----bb-XBB--x>-x--------<>------------------------------------------------XX------xxx--------xxXEEXX---------xx
--------xx--Q--[]----------------------[]--------XX----XXXXXX--<]--xxx-----[]---Q----------QQ------E--------Q--------------QQX------xx--x------xxX--XX--?---------
------xxx------[]---------------E------[]--------XX---XXXXXXXXX[]--<>-x----[]--------------------------------------B---------------xx---?x----xx------------------
-----xx<>------[]------<>------->------[]--------XXEXXXXXXXXXXX[]--[]--xE--[]--?---BB--BS-------B------<>--?-------bB--BB----xxxxxxx------x--xx--------X----o-----
-xxxxx-[]------[]------[]------<]------[]--XXX---XXXXXXXXXXXXXX[]--[]-X-xxx[]------bb--bB------Bb---E--[]-----xxxxxxb--bb-xxxx--E-x--------xxx--------XXXXXXXX-EE-
XXXXXXXXXXXXXXXXXXXXXXXXX------[]---XXXXXX-XXXXX-XXXXXXXXXXXXXXXXXXXXXXXXXXXXXX-XXXXXXXXXXXXXXXXXXXXXXXXXXX-XXX<>XXXXXXXXXXXXX--XXX-----XXXXXXXXXXXXXXXXXXXXXXXXXX
