NNNNNYYNNYYNNYYNNYY
NNNYYNNYYNNYYNNYYNN
NNNNNNNNNNNNNNNNNNN
NNNNNNNNNNNNNNNNNNN
NNNNNNNNNNNNNNNNNNN
-------------------
-------------------
-------------------
-------------------
-------------------
-------------------
-------------------
------------------Q
--------o-o-o?---?-
-------o-o-o----o--
---ooo?-------?o---
----------xxx-----Q
--------xx---x-----
-------xx-----x----
-xxxxxxx-------xxxx
XXXXXXXX-------XXXX
