NNNNNYYNNYYNNYYNNYY
NNNYYNNYYNNYYNNYYNN
NNNNNNNNNNNNNNNNNNN
NNNNNNNNNNNNNNNNNNN
NNNNNNNNNNNNNNNNNNN
-------------------
-------------------
-------------------
-------------------
-------------------
-------------------
-------------------
------------------Q
----------------o?-
-----------o---o---
---oooQooo?-oo?----
------------------?
-------------------
-------------------
-xxxxxxxxxxxxxxxxxx
XXXXXXXXXXXXXXXXXXX
