NNNNNYYNNYYNNYYNNYY
NNNYYNNYYNNYYNNYYNN
NNNNNNNNNNNNNNNNNNN
NNNNNNNNNNNNNNNNNNN
NNNNNNNNNNNNNNNNNNN
-------------------
-------------------
-------------------
-------------------
-------------------
-------------------
-------------------
-------------------
---ooo-------------
------?oo?-oo--oo--
----------Q--?Q--oo
-----------------xx
----------------xx-
---------------xx--
-xxxxxxxxxxxxxxx--X
XXXXXXXXXXXXXXXX---
