NNNNNYYNNYYNNYYNNYY
NNNYYNNYYNNYYNNYYNN
NNNNNNNNNNNNNNNNNNN
NNNNNNNNNNNNNNNNNNN
NNNNNNNNNNNNNNNNNNN
-------------------
-------------------
-------------------
-------------------
-------------------
-------------------
-------------------
-------------------
-------------o?----
-----o------o----o?
---oo-Qooooo---oo--
-----------xx------
----------xx-xxxxxx
---------xx------xX
-xxxxxxxxx-------X-
XXXXXXXXXX---XX----
