NNNNNYYNNYYNNYYNNYY
NNNYYNNYYNNYYNNYYNN
NNNNNNNNNNNNNNNNNNN
NNNNNNNNNNNNNNNNNNN
NNNNNNNNNNNNNNNNNNN
-------------------
-------------------
-------------------
-------------------
-------------------
-------------------
----------------oo-
--------------ooXSQ
-------------o-----
------------o------
---o-----o?oxxxxxxx
----ooo-o--xx-x--xX
-------o--xx-------
---------xx--------
-xxxxxxxxxX--------
XXXXXXXXXXXXXXXXXX-
