NNNNNYYNNYYNNYYNNYY
NNNYYNNYYNNYYNNYYNN
NNNNNNNNNNNNNNNNNNN
NNNNNNNNNNNNNNNNNNN
NNNNNNNNNNNNNNNNNNN
-------------------
-------------------
-------------------
-------------------
-------------------
-------------------
-------------------
-------------------
-------------------
------------o?-----
---oooQooo-o--Q----
----------?------?Q
-------------------
---------------xxxx
-xxxxxxxxxxxxxxx---
XXXXXXXXXXXXXXXX--X
