NNNNNYYNNYYNNYYNNYY
NNNYYNNYYNNYYNNYYNN
NNNNNNNNNNNNNNNNNNN
NNNNNNNNNNNNNNNNNNN
NNNNNNNNNNNNNNNNNNN
-------------------
-------------------
-------------------
-------------------
-------------------
-------------------
-------------------
------QX-----------
---oo?--o--------o-
---------------oo-?
-------o-QQooooxx--
------?-------xx-x-
-------------xx---x
------------xx-----
-xxxxxxxxxxxx------
XXXXXXXXXXXXX-XXXXX
