NNNNNYYNNYYNNYYNNYY
NNNYYNNYYNNYYNNYYNN
NNNNNNNNNNNNNNNNNNN
NNNNNNNNNNNNNNNNNNN
NNNNNNNNNNNNNNNNNNN
-------------------
-------------------
-------------------
-------------------
-------------------
-------------------
-------------------
-------------------
-------------------
-------------------
---------------ooo?
---oooQ-oQQoooQ----
-------------------
------------------x
-xxxxxxxxxxxxxxxxxx
XXXXXXXXXXXXXXXXXXX
