NNNNNYYNNYYNNYYNNYY
NNNYYNNYYNNYYNNYYNN
NNNNNNNNNNNNNNNNNNN
NNNNNNNNNNNNNNNNNNN
NNNNNNNNNNNNNNNNNNN
-------------------
-------------------
-------------------
-------------------
-------------------
-------------------
-------------------
-------------------
-------------------
-----------ooo-----
-----oQooo?---QoooQ
---oo--------------
-------------------
------------------x
-xxxxxxxxxxxxxxxxxx
XXXXXXXXXXXXXXXXXXX
