NNNNNNNNNNNYYNNYYNNNNNNNNNNNNNNNNNNNNNNNNNNNNNNNNNNNNNNNNNNNNNNNNNNNNNNNNNNYYNNYYNNNNNNYYNNNNNNNNNNYYNNYYNNNNNNNNNNNNNNNNNNNNNNYYNNNNNNNNNNYYNNNNNNYYNNNNNNNNNNNNN
NNNYYNNNNNNNNNNNNNNNNNNNNNNNNNNNNNNNNNNNNNNNNNNNNNNNNNNYYNNNNNNNNNNNNNNNNNNNNNNNNNNYYNNNNNNNNNNNNNNNNNNNNNNYYNNYYNNNNNNNNNNYYNNNNNNNNNNNNNNNNNNYYNNNNNNNNNNNNNNNNN
NNNNNNNYYNNNNNNNNNNNNNNYYNNNNNNYYNNNNNNNNNNYYNNNNNNYYNNNNNNYYNNYYNNNNNNNNNNNNNNNNNNNNNNNNNNYYNNNNNNNNNNNNNNNNNNNNNNYYNNNNNNNNNNNNNNNNNNNNNNNNNNNNNNNNNNNNNNNNNNNNN
NNNNNNNNNNNNNNNNNNNYYNNNNNNNNNNNNNNYYNNYYNNNNNNYYNNNNNNNNNNNNNNNNNNYYNNYYNNNNNNNNNNNNNNNNNNNNNNYYNNNNNNNNNNNNNNNNNNNNNNYYNNNNNNNNNNYYNNYYNNNNNNNNNNNNNNYYNNNNNNNNN
NNNNNNNNNNNNNNNNNNNNNNNNNNNYYNNNNNNNNNNNNNNNNNNNNNNNNNNNNNNNNNNNNNNNNNNNNNNNNNNNNNNNNNNNNNNNNNNNNNNNNNNNNNNNNNNNNNNNNNNNNNNNNNNNNNNNNNNNNNNNNNNNNNNNNNNNNNNYYNNYYN
------------------------------------------------------------------------------------------------------------------------------------------------------------------
------------------------------------------------------------------------------------------------------------------------------------------------------------------
------------------------------------------------------------------------------------------------------------------------------------------------------------------
----------------------------------------------------------------------------------------------------------XX------------------------------------------------------
------------------------------------------------------------------------------------------------------------------------------------------------------------------
------------------------------------------------------------------------------------------------------------o-----------------------------------------------------
-------------------------------EE------------------EE---o------EE--SSSSS-----------------------------------oXX-------------??-------------------------------------
--------E---QSSQQSSSSSSSSSSSSSSSSSSSSSSSSSSSSSSSSSSSSSSSSSSSSSSSSSSSSSS[]--QQ--?--------------------Q------X----o------------------------------------------X------
-----------------------------------------------------------------------[]--------------------------------------oo------------------------------oo------<----------
-----------------------------------------------------------------------X]-----------o--------------------------o-------------------------------oo------[>---------
-------E-----------EE--EE--E-------EE--EE--EE--EE------E---EE------EE---]----------o---QQ--------------------------------xxxx--Q-----------QQ------QQ--[]---------
---oo--S--S?S--SSSSSSSSSSSSSSSSSSSSSSSSSSSSSSSSSSSSSSSXSSSSSSSSSSSSSSSS--------QQ-----------------xxx--QQ---------------xxXX-x--Q----------------------[]---------
----------------------------E---------------------------------------------xxx---------xxx--------xx--x-----------------xx-XX--x-------------------xxx--[]---------
------------------------------------xxxx----------------------------xx---xx--xx------xx--xxxxxxxxx-?--xxxxxxxxxxxxxxxxxx>-XX---x--xxxxxxxxxxxxxxxxx--xx[]---<>-<>-
-xxxxxxxxxxxxxxxxxxxxxxxxxxxxxxxxxxxx---xxxxxxxxxxxxxxxxxxxxxxxxxxxxx-xxxx-----xxxxxxxXXXXXEEXX<>XX---XXXXXXXXXXXXXEEXX<]-XX----xxx<>XX<>XXXXXXXXXXXXXXXX--B[]-[]-
XXXXXXXXXXXXXXXXXXXXXXXXXXXXXXXXXXXXX--XXXXXXXXXXXXXXXXXXXXXXXXXXXXXXXXXXXX---XXXXXXXXXXXXXXXXX[]XX---XXXXXXXXXXXXXXXXX[]-XXXXXXXXX[]--[]XXXXXXXXXXXXXXXX--XXXXXXX
