NNNNNYYNNYYNNYYNNYY
NNNNNNNNNNNNNNNNNNN
NNNNNNNNNNNNNNNNNNN
NNNNNNNNNNNNNNNNNNN
NNNYYNNYYNNYYNNYYNN
-------------------
-------------------
-------------------
-------------------
-------------------
-------------------
-------------------
----------SSS------
-------------------
-------------------
-------------------
-----QQB-QQ--QQ--QQ
-------bB--B----B--
---BB---b--bE--Bb--
-xxxxxxxxxxxxxxxxxx
XXXXXXXXXXXXXXXXXXX
