NNNNNYYNNYYNNYYNNYY
NNNNNNNNNNNNNNNNNNN
NNNNNNNNNNNNNNNNNNN
NNNNNNNNNNNNNNNNNNN
NNNYYNNYYNNYYNNYYNN
-------------------
-------------------
-------------------
-------------------
-------------------
-------------------
-------------------
------SSS----------
-------------------
-------------------
-------------------
-----QQB-QQ--Q?--QQ
---B---b---B---B---
---bB---E--bB--bB--
-xxxxxxxxxxxxxxxxxx
XXXXXXXXXXXXXXXXXXX
