NNNNNYYNNYYNNYYNNYY
NNNNNNNNNNNNNNNNNNN
NNNNNNNNNNNNNNNNNNN
NNNNNNNNNNNNNNNNNNN
NNNYYNNYYNNYYNNYYNN
-------------------
-------------------
-------------------
-------------------
-------------------
-------------------
-------------------
------SSS----------
-------------------
-------------------
-------------------
-----QQ--QQB-QQ--QQ
---B---B---bB--B---
---bB--bE---b--bB--
-xxxxxxxxxxxxxxxxxx
XXXXXXXXXXXXXXXXXXX
