NNNNNYYNNYYNNYYNNYY
NNNNNNNNNNNNNNNNNNN
NNNNNNNNNNNNNNNNNNN
NNNNNNNNNNNNNNNNNNN
NNNYYNNYYNNYYNNYYNN
-------------------
-------------------
-------------------
-------------------
-------------------
-------------------
-------------------
--------------SSSSS
-------------------
-------------------
-------------------
-----QQ--QQ--QQESQQ
---BB------BB------
---bb--BB--bb---E--
-xxxxxxxxxxxxxxxxxx
XXXXXXXXXXXXXXXXXXX
