NNNNNYYNNYYNNYYNNYY
NNNNNNNNNNNNNNNNNNN
NNNNNNNNNNNNNNNNNNN
NNNNNNNNNNNNNNNNNNN
NNNYYNNYYNNYYNNYYNN
-------------------
-------------------
-------------------
-------------------
-------------------
-------------------
-------------------
--------------SSS--
-------------------
-------------------
-------------------
-----QQ--QQ--QQ--?Q
---BB--B---B---B---
---bb--bB--bB--bE--
-xxxxxxxxxxxxxxxxxx
XXXXXXXXXXXXXXXXXXX
