NNNNNYYNNYYNNYYNNYY
NNNNNNNNNNNNNNNNNNN
NNNNNNNNNNNNNNNNNNN
NNNNNNNNNNNNNNNNNNN
NNNYYNNYYNNYYNNYYNN
-------------------
-------------------
-------------------
-------------------
-------------------
-------------------
-------------------
------SSSS---------
-------------------
-------------------
-------------------
-----QQBSQQ--QQ----
---BB--b---BB--B-??
---bb---E--bb--bB--
-xxxxxxxxxxxxxxxxxx
XXXXXXXXXXXXXXXXXXX
