NNNNNYYNNYYNNYYNNYY
NNNNNNNNNNNNNNNNNNN
NNNNNNNNNNNNNNNNNNN
NNNNNNNNNNNNNNNNNNN
NNNYYNNYYNNYYNNYYNN
-------------------
-------------------
-------------------
-------------------
-------------------
-------------------
-------------------
---------SSSSSQSSQS
-------------------
-------------------
-------------------
-----?Q--Q?E-?S--SQ
---BB------SE--BE--
---bb--BB------b---
-xxxxxxxxxxxxxxxxxx
XXXXXXXXXXXXXXXXXXX
