NNNNNYYNNYYNNYYNNYY
NNNNNNNNNNNNNNNNNNN
NNNNNNNNNNNNNNNNNNN
NNNNNNNNNNNNNNNNNNN
NNNYYNNYYNNYYNNYYNN
-------------------
-------------------
-------------------
-------------------
-------------------
-------------------
-------------------
----------SSSSQSSS-
-------------------
-------------------
-------------------
-----QQ--QQ--?SBEQQ
----B------B<--b---
---Bb--BB--b---B---
-xxxxxxxxxxxxxxxxxx
XXXXXXXXXXXXXXXXXXX
