NNNNNYYNNYYNNYYNNYY
NNNNNNNNNNNNNNNNNNN
NNNNNNNNNNNNNNNNNNN
NNNNNNNNNNNNNNNNNNN
NNNYYNNYYNNYYNNYYNN
-------------------
-------------------
-------------------
-------------------
-------------------
-------------------
-------------------
------?------------
-------------------
-------------------
---------QQ--QQ--QQ
-----QQ------------
---BB---B--BB--BB--
---bb-xxxxxxxxxxxxx
-xxxxxxBXXXXXXXXXXX
XXXXXXXXXXXXXXXXXXX
