NNNNNYYNNYYNNYYNNYY
NNNNNNNNNNNNNNNNNNN
NNNNNNNNNNNNNNNNNNN
NNNNNNNNNNNNNNNNNNN
NNNYYNNYYNNYYNNYYNN
-------------------
-------------------
-------------------
-------------------
-------------------
-------------------
-------------------
-------------------
-------------------
-------------------
-------------------
-----QQ--QQ--QQ--??
-------BB--B---B---
----B--bb--bB--bB--
-xxxxxxxxxxxxxxxxxx
XXXBXXXXXXXXXXXXXXX
