NNNNNNNNNNNNNNNNNNN
NNNNNYYNNYYNNYYNNYY
NNNYYNNYYNNYYNNYYNN
NNNNNNNNNNNNNNNNNNN
NNNNNNNNNNNNNNNNNNN
-------------------
-------------------
-------------------
-------------------
-------------------
-------------------
-------------------
-------------------
-------------------
----------o--oo----
-----oo--o--------o
---EE--oo--------o-
----------------E--
-------xxxxxxx-----
-xxxxxxx---EE-xxxxx
XXXXXXXX----XXXEXXX
