NNNNNNNNNNNNNNNNNNN
NNNNNYYNNYYNNYYNNYY
NNNYYNNYYNNYYNNYYNN
NNNNNNNNNNNNNNNNNNN
NNNNNNNNNNNNNNNNNNN
-------------------
-------------------
-------------------
-------------------
-------------------
-------------------
-------------------
-------------------
-------------------
-------------oo----
-----oo----------oo
---EE--oooo-E--Eo--
-------------------
-----------E-------
-xxxxxxxxxxxxxxxxxx
XXXXXXXXXXXXXXXXXXX
