NNNNNNNNNNNNNNNNNNN
NNNNNYYNNYYNNYYNNYY
NNNYYNNYYNNYYNNYYNN
NNNNNNNNNNNNNNNNNNN
NNNNNNNNNNNNNNNNNNN
-------------------
-------------------
-------------------
-------------------
-------------------
-------------------
-------------------
-------------------
------o------------
-----o---oo--oo----
-----------E------o
----E-------E------
---E---------------
-----------xxxxxxxx
-xxxxxxxxxxx---EE--
XXXXXXXEEXXX-----E-
