NNNNNNNNNNNNNNNNNNN
NNNNNYYNNYYNNYYNNYY
NNNYYNNYYNNYYNNYYNN
NNNNNNNNNNNNNNNNNNN
NNNNNNNNNNNNNNNNNNN
-------------------
-------------------
-------------------
-------------------
-------------------
-------------------
-------------------
-------------------
-------------------
---------oo--------
-----oo------ooEEoo
----E---E----------
---E---E-----------
-------------------
-xxxxxxxxxxxxxxxxxx
XXXXXXXXXXXEXXXXXXX
