NNNNNNNNNNNNNNNNNNN
NNNNNYYNNYYNNYYNNYY
NNNYYNNYYNNYYNNYYNN
NNNNNNNNNNNNNNNNNNN
NNNNNNNNNNNNNNNNNNN
-------------------
-------------------
-------------------
-------------------
-------------------
-------------------
----------oo-o-----
--------EoXXX-o----
--------XX---------
-----ooE-----------
----o------------oo
---E---------------
---E-----------E---
---------xxxx--xxxx
-xxxxxxxxx---xxxEXX
XXXXXXXXXX--EXXXXXX
