NNNNNNNNNNNNNNNNNNN
NNNNNYYNNYYNNYYNNYY
NNNYYNNYYNNYYNNYYNN
NNNNNNNNNNNNNNNNNNN
NNNNNNNNNNNNNNNNNNN
-------------------
-------------------
-------------------
-------------------
-------------------
-------------oo----
------------E------
-------------------
-------------------
----------xxxxxx---
-----oo--xx-----xxx
--------xx---------
---E---xx----------
---xxxxx--o------oo
-xxxE-xEEoXE--XEEXX
XXXXXXXXXXXXXXXXXXX
