NNNNNNNNNNNNNNNNNNN
NNNNNYYNNYYNNYYNNYY
NNNYYNNYYNNYYNNYYNN
NNNNNNNNNNNNNNNNNNN
NNNNNNNNNNNNNNNNNNN
-------------------
-------------------
-------------------
-------------------
-------------------
-------------------
-------------------
-----------------oo
-----oo------------
--------------o----
---------oo--o-----
----E------oo------
---E---------------
-----------xxxxxxx-
-xxxxxxxxxxx---EE-x
XXXXXXXEEXXX----XXX
