NNNNNNNNNNNNNNNNNNN
NNNNNYYNNYYNNYYNNYY
NNNYYNNYYNNYYNNYYNN
NNNNNNNNNNNNNNNNNNN
NNNNNNNNNNNNNNNNNNN
-------------------
-------------------
-------------------
-------------------
-------------------
-------------------
-------------------
-------------oo----
-------------X-----
-----------------oo
------o--oo-E--xxxo
----Eo-Eo--E--xx--x
---E---------xx---X
------------xx-EEX-
-xxxxxxxxxxxx------
XXXXXXXXXXXXX------
