NNNNNNNNNNNNNNNNNNN
NNNNNYYNNYYNNYYNNYY
NNNYYNNYYNNYYNNYYNN
NNNNNNNNNNNNNNNNNNN
NNNNNNNNNNNNNNNNNNN
-------------------
-------------------
-------------------
-------------------
-------------------
-------------------
-------------------
-----oo------------
-----XXo-----------
----E--Xoo---------
--------X-o--oo--oo
---E-------oo--oo--
------------------x
-----------------xx
-xxxxxxxxxxxxxxxxx-
XXXXXXXXXXXXXXXXXX-
