NNNNNNNNNNNNNNNNNNN
NNNNNYYNNYYNNYYNNYY
NNNYYNNYYNNYYNNYYNN
NNNNNNNNNNNNNNNNNNN
NNNNNNNNNNNNNNNNNNN
-------------------
-------------------
-------------------
-------------------
-------------------
-------------------
-------------------
-------------------
-------------------
-------------------
--------Eoo---o----
----oooE-----------
---E---------------
----------xxxxxxxxx
-xxxxxxxxxxEE--EEEE
XXXXXXXXXXX--E---XX
