NNNNNNNNNNNNNNNNNNN
NNNNNNNNNNNNNNNNNNN
NNNNNNNNNNNNNNNNNNN
NNNNNYYNNYYNNYYNNYY
NNNYYNNYYNNYYNNYYNN
-------------------
-------------------
-------------------
-------------------
-------------------
-------------------
-------------------
------------xxxx---
------------x<>----
----------xxx[]-x--
---------xx<>[]--xx
--------xxE[][]--<>
----B--xx<>[][]<>[]
---BbxxxB[][][][][]
-xxxxx<>b[][]XX[][]
XXXXXX[]XXXXXXXXXXX
