NNNNNNNNNNNNNNNNNNN
NNNNNNNNNNNNNNNNNNN
NNNNNNNNNNNNNNNNNNN
NNNNNYYNNYYNNYYNNYY
NNNYYNNYYNNYYNNYYNN
-------------------
-------------------
-------------------
-------------------
-------------------
-------------------
-------------------
-------------------
-------------------
-------------------
-------------------
--------B----------
---B----b-E--------
---bB<-BBB-BB---B--
-xxxxxxxxxxxxxxxxxx
XXXXXXXXXXXXX<>BX<>
