NNNNNNNNNNNNNNNNNNN
NNNNNNNNNNNNNNNNNNN
NNNNNNNNNNNNNNNNNNN
NNNNNYYNNYYNNYYNNYY
NNNYYNNYYNNYYNNYYNN
-------------------
-------------------
-------------------
-------------------
-------------------
-------------------
-------------------
-------------------
-------------------
-------------------
-----<>------------
-----[]--------->--
----B[]--EE->-E<]<>
---Bb[]->-><]<>[][]
-xxxx[]<]<][][][][]
XXXXXXX[XXXXXXXXXXX
