NNNNNNNNNNNNNNNNNNN
NNNNNNNNNNNNNNNNNNN
NNNNNNNNNNNNNNNNNNN
NNNNNYYNNYYNNYYNNYY
NNNYYNNYYNNYYNNYYNN
-------------------
-------------------
-------------------
-------------------
-------------------
-------------------
-------------------
-------------------
-------------------
-------------------
-------------------
-----------------xx
---BB-------xxxxxxB
---bb--BBxxxxE<><><
-xxxxxxxxx><>-[][][
XXXXX<>XX<][]-XXXXX
