NNNNNNNNNNNNNNNNNNN
NNNNNNNNNNNNNNNNNNN
NNNNNNNNNNNNNNNNNNN
NNNNNYYNNYYNNYYNNYY
NNNYYNNYYNNYYNNYYNN
-------------------
-------------------
-------------------
-------------------
---SSSSSSSSSSSSSSSS
----SSSSSSSSSSSSSSS
----SSSSSSSSSSSSSSS
-------------------
-------------------
-------------------
-----E-E-----E-E---
----SSSSSSSSSSSSSSS
------E--EE-----E--
---BB---E--E--E--EE
-xxxxxxxxxxxxxxxxxx
XXXXXXXXXXXXEXXXXXX
