NNNNNNNNNNNNNNNNNNN
NNNNNNNNNNNNNNNNNNN
NNNNNNNNNNNNNNNNNNN
NNNNNYYNNYYNNYYNNYY
NNNYYNNYYNNYYNNYYNN
-------------------
-------------------
-------------------
-------------------
-------------------
-------------------
-------------------
-------SSS---------
-------------------
-------------------
-------------------
-------------------
---B----E<-B-------
---bBE-B---bB--BB--
-xxxxxxxxxxxxxxxxxx
XXXXXXXXXXXXX<>XX<>
