NNNNNNNYYNNYYNNNNNNNNNNNNNNNNNNYYNNNNNNNNNNYYNNNNNNNNNNNNNNYYNNNNNNYYNNNNNNNNNNNNNNNNNNNNNNNNNNYYNNNNNNYYNNNNNNYYNNNNNNNNNNNNNNYYNNYYNNNNNNNNNNNNNNNNNNNNNNNNNNNNN
NNNNNNNNNNNNNNNNNNNNNNNNNNNNNNNNNNNNNNNNNNNNNNNNNNNNNNNNNNNNNNNNNNNNNNNNNNNYYNNYYNNYYNNNNNNNNNNNNNNNNNNNNNNNNNNNNNNNNNNNNNNNNNNNNNNNNNNNNNNNNNNNNNNNNNNNNNNNNNNNNN
NNNYYNNNNNNNNNNYYNNYYNNYYNNNNNNNNNNNNNNYYNNNNNNNNNNNNNNYYNNNNNNYYNNNNNNNNNNNNNNNNNNNNNNYYNNNNNNNNNNNNNNNNNNNNNNNNNNNNNNNNNNYYNNNNNNNNNNNNNNYYNNYYNNNNNNYYNNYYNNYYN
NNNNNNNNNNNNNNNNNNNNNNNNNNNYYNNNNNNYYNNNNNNNNNNYYNNYYNNNNNNNNNNNNNNNNNNNNNNNNNNNNNNNNNNNNNNNNNNNNNNYYNNNNNNYYNNNNNNNNNNYYNNNNNNNNNNNNNNYYNNNNNNNNNNNNNNNNNNNNNNNNN
NNNNNNNNNNNNNNNNNNNNNNNNNNNNNNNNNNNNNNNNNNNNNNNNNNNNNNNNNNNNNNNNNNNNNNNYYNNNNNNNNNNNNNNNNNNYYNNNNNNNNNNNNNNNNNNNNNNYYNNNNNNNNNNNNNNNNNNNNNNNNNNNNNNYYNNNNNNNNNNNNN
------------------------------------------------------------------------------------------------------------------------------------------------------------------
------------------------------------------------------------------------------------------------------------------------------------------------------------------
------------------------------------------------------------------------------------------------------------------------------------------------------------------
------------------------------------------------------------------------------------------------------------------------------------------------------------------
------------------------------------------------------------------------------------------------------------------------------------------------------------------
----------------------------------------------------------------------------------------------------X-------------------------------------------------------------
------------------------------------------------------------------------------------o--------------X---------------------------------------------------E--------E-
----XXXQQ--------------E-----------------------------------QQ------?Q--------------o------------?-----xxx---------------------------------------------------------
-----------------------------------------------<-------------------------------oo------EE------------xx--x--xxxxxx---------------------------------------------E--
---E-------------------------------------------[>---------------------------------------------------xXX---xxx---Q-x--------------------<>-------------------------
-----------------------------------------------[]--------------------------oo-------------------xxxxE------x>--?---xxx-----------------[]------------------------x
-------QQ--QQ-----------E------QQ----------QQ--[]----------QQ------SQ-------------------------xxxXXXE--QQ--<]------<>-x--------?Q--QQ--[]------------------------x
----xx---------EE--EE------------------EE------X]-xxxx---------xxxxx---B---------------------xx?----------X[]------[]--xxx-E-----------XX-xxxxx----BB-----------xx
---xx-x-----------------------xxx----------------xx<>-xE------xx----x--bB------------------xxx-----------XX[]---Q--[]--<>-xxxxxx---------xx----xxxxxxxxxxxxxxxxxxX
-xxxE--xxxxxxxxxxxxxxxxxxxxxxxx--xxxxxxxxxxxxxxxxx-[]--xxxxxxxxEE----xxxxxxxxxxxxxxxxxx--XXB<>-----------XX[]------[]--[]--xE---xxxxxxxxxx-EE-XEEXXXXXXXEXXEEXXXXX
XXXXXXXXXXXXXXXXXXXXXXXXXXX<>XXXXXX<>XXXXXXXXXXXXXXXXXXXEXXXXXXXXXXXXXXXXXXXXXXXXXXXXXX--XXX[]-XX--------XXXXXXX---XXXXXXXXX---XXXXXXXXXXXXXXXXXXXXXXXXXXXXXXXXXXX
