NNNNNNNNNNNNNNNNNNN
NNNNNNNNNNNNNNNNNNN
NNNNNNNNNNNNNNNNNNN
NNNNNNNNNNNNNNNNNNN
NNNNNYYNNYYNNYYNNYY
-------------------
-------------------
-------------------
-------------------
-------------------
-------------------
-------------------
-------------------
-------------------
----------------xxx
---------------xx-x
--------------xx-->
----------B-xxx--<]
-----BB--Bbxx<>--[]
-xxxxxxxxxxx-[]--[]
XXXXXXXXXXXX-XXXXXX
