NNNNNNNNNNNNNNNNNNN
NNNNNNNNNNNNNNNNNNN
NNNNNNNNNNNNNNNNNNN
NNNNNNNNNNNNNNNNNNN
NNNNNYYNNYYNNYYNNYY
-------------------
-------------------
-------------------
-------------------
-------------------
-------------------
-------------------
-------------SS----
-------------------
-------------------
-------------------
-------------B-----
-----B---B---b---B-
-----bB--bB---E--bB
-xxxxxxxxxxxxxxxxxx
XXXXXXXXXXXXXXXXXXX
