NNNNNNNNNNNNNNNNNNN
NNNNNNNNNNNNNNNNNNN
NNNNNNNNNNNNNNNNNNN
NNNNNNNNNNNNNNNNNNN
NNNNNYYNNYYNNYYNNYY
-------------------
-------------------
-------------------
-------------------
-------------------
-------------------
-------------------
-------------------
-------------------
-------------------
--------xxxx-------
-------xx<>-x------
------xx-[]--xx---B
---xxxx--[]--BBx-Bb
-xxx-<>--[]--bB-xxx
XXXX-[]--XXXXXXXXXX
