NNNNNNNNNNNNNNNNNNN
NNNNNNNNNNNNNNNNNNN
NNNNNNNNNNNNNNNNNNN
NNNNNNNNNNNNNNNNNNN
NNNNNYYNNYYNNYYNNYY
-------------------
-------------------
-------------------
-------------------
-------------------
-------------------
-------------------
------------SSS----
-------------------
-------------------
---------B--X------
---------b--XSQ----
------B-----X----B-
-----Bb--xxxx----bB
-xxxxxxxxxB-xxxxxxx
XXXXXXXXXXXXX<XXXXX
