NNNNNNNNNNNNNNNNNNN
NNNNNNNNNNNNNNNNNNN
NNNNNNNNNNNNNNNNNNN
NNNNNNNNNNNNNNNNNNN
NNNNNYYNNYYNNYYNNYY
-------------------
-------------------
-------------------
-------------------
-------------------
-------------------
-------------------
-------------------
-------------------
-------------------
-------------B-----
-------------b---B-
-----B---BB---B--b-
-----bB--bb---b---B
-xxxxxxxxxxxxxxxxxx
XXXXXXXXXXXXXXXXXXX
