NNNNNNNNNNNNNNNNNNN
NNNNNNNNNNNNNNNNNNN
NNNNNNNNNNNNNNNNNNN
NNNNNNNNNNNNNNNNNNN
NNNNNYYNNYYNNYYNNYY
-------------------
-------------------
-------------------
-------------------
-------------------
-------------------
-------------------
----SSSS-----------
-------------------
-------------------
-----------------<E
---------B-------[>
---------b---B---X-
-----EB---B--bB----
-xxxxxxxxxxxxxxxxxx
XXXXXXXXXXXXXXXXXXX
