NNNNNNNNNNNNNNNNNNN
NNNNNNNNNNNNNNNNNNN
NNNNNNNNNNNNNNNNNNN
NNNNNNNNNNNNNNNNNNN
NNNNNYYNNYYNNYYNNYY
-------------------
-------------------
-------------------
-------------------
-------------------
-------------------
-------------------
-------------------
-------------------
-------------------
-------------------
-----------------B-
-----B---B---BB--b-
-----bB--bB--bb--BB
-xxxxxxxxxxxxxxxxxx
XXXXXXXXXXXXXXXXXXX
