NNNNNYYNNYYNNYYNNYYNNYYNNYYNNYYNNYYNNYYNNYYNNYYNNYYNNYYNNYYNNYYNNYYNNYYNNYYNNY
------------------------------------------------------------------------------
------------------------------------------------------------------------------
---------------------------------------------------------------------------xxx
--------------------------------------------------------------------------xx--
--------------------------------xxxxx------------------------xxx---------xx---
-------------------------------xx----xxx--xx--------xxx-----xx--x-------xxE---
-------------------------------xE----<>-xxX-xxx----xx--x---xx----x------x-X---
------------------------------xxX-X--[]-XX-----x---x--E-x-xx------x----xx-]---
------------------------------xXXX---[]------<E-x-xx-----xx--------x--xxS-]---
-----------------------------xxXX----[]------[>--xx---E---x---o-----xxx--<]---
--------xxxx----------------xxEXX----X-------[]--<>--<>--<>---E------xE--[]---
-------xx<>-x--------------xx<>XX------------[]--[]--[]--[]--<>---E--<>--[]---
------xx-[]--x------------xxX[]XX-E----------[]--[]--[]--[]--[]--<>--[]--[]--<
----xxx--[]---xxx------xxxxXX[]XX<>------<E--[]--[]--[]--[]--[]--[]--[]--[]--[
-xxxx<>--[]--<>X-xxxxxxx-<>XXXXXX[]------[>--XXXXXXXXXXXXXX--[]X-[]--[]--X]--[
XXXXX[]--XXXX[]XX<>XX<>X-[]XXXXXX[]------[]--XXXXXXXXXXXXXX--[]--[]--XXXXXX--X
