NNNNNYYNNYYNNYYNNYYNNYYNNYYNNYYNNYYNNYYNNYYNNYYNNYYNNYYNNYYNNYYNNYYNNYYNNYYNNY
------------------------------------------------------------------------------
------------------------------------------------------------------------------
------------------------------------------------------------------------------
------------------------------------------------------------------------------
------------------------------------------------------------------------------
------------------------------------------------------------------------------
------------------------------------------------------------------------------
------------------------------------------------------------------------------
------------------------------------------------------------------------------
------------------------------------------------xxxx--------------------------
--------------------------E-----------xxxxxx---xx<>-x----<E-------------------
-------------------------<>---------xxx--<>-x-xx-[]--x---[>-------E----------<
-----------------------------------xx<>--[]--xx--[]---xx-X]------<>--<E-xxxx--
-----------------<>---------xxxxxxxx-[]--[]--<>--[]--<>-x[X-xxxxx----->xx<>-x-
-xxxxxxxxxxxxxxxxxxxxxxxxxxxx<>XE<>--[]--[]--[]--[]--[]--xxxx<>X-xxxxxxx-[]--x
XXXXX<>XX<>XX<>XXXXXX<>XXXXXX[]XX[]XXXXXXXXXXXXXXXXXXXXXXXXXX[]XXXXXXXXXXXXXXX
