NNNNNYYNNYYNNYYNNYYNNYYNNYYNNYYNNYYNNYYNNYYNNYYNNYYNNYYNNYYNNYYNNYYNNYYNNYYNNY
------------------------------------------------------------------------------
------------------------------------------------------------------------------
------------------------------------------------------------------------------
------------------------------------------------------------------------------
------------------------------------------------------------------------------
------------------------------------------------------------------------------
-------------------------------------------xxxx------------------S-----------X
------------------------------------------xxXXEx-----------------------------[
------------------------------------------xXX[]-x----------------------------[
---------------------------------------xxxxXX[]--xxx-------------------------[
------E-----------E-------------------xx-<>XX[]--<>-x------------------------X
-----<>----------<>---------------E--xx--[]XX[]--[]--xxx--------xxxx----------
---?--------------------------E--<>-xxE--[]XX[]--[]--<>-xxxx---xx<>-xxxx------
------------xxxxx------------<>----xx<>--[]XX[]-X[]--[]--xE-xxxx-[]--xE-xxxxxx
-xxxxxxxxxxxx<>X-xxxxxxxxxxxxxxxxxxxX[]XXXXXXX]XXXXXXXXXX<>XX<>XXXXXX<>XX<>XEX
XXXXXXXXX<>XX[]XXXXXX<>XX<>XXXXXXXXXXXXXXXXXXXXXXXXXXXXXX[]XX[]XXXXXX[]XX[]XXX
