NNNNNYYNNYYNNYYNNYYNNYYNNYYNNYYNNYYNNYYNNYYNNYYNNYYNNYYNNYYNNYYNNYYNNYYNNYYNNY
------------------------------------------------------------------------------
------------------------------------------------------------------------------
------------------------------------------------------------------------------
------------------------------------------------------------------------------
------------------------------------------------------------------------------
------------------------------------------------------------------------------
------------------------------------------------------------------------------
------------------------------------------------------------------------------
------------------------------------------------------------------------------
---------------------<E------<E--<E--------------------------------------<----
---------------------[>------[>--[>-----------E--<E------<E--<E------<E--[>---
---------------------[]--<---[]--[]------<E--<>--[>------[>--[>--<E--[>--[]---
------E-------E-xxxx-[]--[>--[]--[]--<E--[>--[]--[]------[]--[]--[>--[]--[]--<
-----<>------<>xx<>-x[]--[]--[]--[]--[>--[]--[]--[]E-<>--[]--[]--[]--[]--[]--[
-xxxxxxxxxxxxxxx-[]--[]-XXXXXXXXXXX--X]--XXXXXXXXXXX-[]--XXXXXXXXXXXXXXXXXXXXX
XXXXXXXXX<>XXXXX-XXXXXXXXXXXXXXXXXX--XXXXXXXXXXXXXXX-XXXXXXXXXXXXXXXXXXXXXXXXX
