NNNNNYYNNYYNNYYNNYYNNYYNNYYNNYYNNYYNNYYNNYYNNYYNNYYNNYYNNYYNNYYNNYYNNYYNNYYNNY
------------------------------------------------------------------------------
------------------------------------------------------------------------------
------------------------------------------------------------------------------
------------------------------------------------------------------------------
------------------------------------------------------------------------------
------------------------------------------------------------------------------
------------------------------------------------------------------------------
------------------------------------------------------------------------------
------------------------------------------------------------------------------
-----------------------------------------<E-----------------------------------
---------<E------<------------E---E------[>--<E---E-----------E---------------
-----<>--[>--<>--[>------<E--<>--<>--<E--[]--[>--<>--<E--<E--<>---E------<E---
----B[]--[]--[]--[]--<E--[>--[]--[]--[>--[]--[]--[]--[>--[>--[]--<>--<E--[>--<
----b[]--[]--[]--[]--[>--[]--[]--[]--[]--X]--[]--[]--[]--[]--[]--[]--[>--[]--[
-xxxx[]--XXXXXXXXXXXXX]--XXXE[]--XXXXXXXXXXXXXXXXXXXXX]-XXXXXXXXXXXXXX]--X]--[
XXXXXXXXXXXXXXXXXXXXXXXXXXXXXXXXXXXXXXXXXXXXXXXXXXXXXXXXXXXXXXXXXXXXXXXXXXX--X
