NNNNNYYNNYYNNYYNNYYNNYYNNYYNNYYNNYYNNYYNNYYNNYYNNYYNNYYNNYYNNYYNNYYNNYYNNYYNNY
------------------------------------------------------------------------------
------------------------------------------------------------------------------
------------------------------------------------------------------------------
------------------------------------------------------------------------------
------------------------------------------------------------------------------
------------------------------------------------------------------------------
------------------------------------------------------------------------------
-----<EX-------------------------<>---E---------------------------------------
-----[>--------------------------[]--<>-----------E---------------------------
-----[]--------------------------[Q--[]----------<>---------------------------
-----X]------------------------------XX----------[]-------------------E--<>---
------X------------------------xx-----X---E-----S[X------------------<>--[]--<
------------------------------xx?x-------<>---E------------------<>------[]--[
---------------------------xxxx---x----------<>-----xxxxx----------------[]--[
-xxxxxxxxxxxxxxxxxxxxxxxxxxx-<>----xxxxxxxxxxxxxxxxxx<>E-xxxxxxxxxxxxxxxx[]--X
XXXXXXXXX<>XX<>XX<>XX<>XX<>X-[]XXXXXXXXXXXXXXXXXXXXXX[]XX<>XX<>XXXXXXXXXXXXXXX
