NNNNNYYNNYYNNYYNNYYNNYYNNYYNNYYNNYYNNYYNNYYNNYYNNYYNNYYNNYYNNYYNNYYNNYYNNYYNNY
------------------------------------------------------------------------------
------------------------------------------------------------------------------
------------------------------------------------------------------------------
------------------------------------------------------------------------------
------------------------------------------------------------------------------
------------------------------------------------------------------------------
------------------------------------------------------------------------------
----------------------------------E-------------------------------------------
---------------------------------<>---E---------------------------------------
---------------------------------[]--<>-----------E---------------------------
---------------------------------XX--[]----------<>---E-----------E------<E---
------------xxxx----xxxx----xxxx-----[]--<>------[]--<>--<E--<E--<>--<E--[>--<
-----------xx<>-x--xx<>-x--xx<>-x----[]--[]--<>--[]--[]--[>--[>--[]--[>--[]--[
----xxxxxxxx-[]--xxx-[]--xxx-[]--xxxx[]--[]--[]--[]--[]--[]--[]--[]--[]--[]--[
-xxxx<>XE<>XXXXXX<>XXXXXX<>XXXXX-XXXXXXXXXXXXXXXXXXXXXXXXX]--XX--XXXXXXXXXXXXX
XXXXX[]XX[]XXXXXX[]XXXXXX[]XXXXX-XXXXXXXXXXXXXXXXXXXXXXXXXX--XX--XXXXXXXXXXXXX
