NNNNNYYNNYYNNYYNNYYNNYYNNYYNNYYNNYYNNYYNNYYNNYYNNYYNNYYNNYYNNYYNNYYNNYYNNYYNNY
------------------------------------------------------------------------------
------------------------------------------------------------------------------
------------------------------------------------------------------------------
------------------------------------------------------------------------------
------------------------------------------------------------------------------
------------------------------------------------------------------------------
------------------------------------------------------------------------------
------------------E-----------------------------------------------------------
-----------------<>-----------------------------------------------------------
----------xxx----[]---------------------------------------------------E-------
--------xxx--x---XX------------------<>----------EE--------------<---<>---E--<
-------xx<>---xx--X-----xxxx---------[]--<---<>--<>--<E--<E--<E--[>--[]---E--[
------xx-[]--<>-x------xx<>-x--xxxxx-[]--[>--[]--[]--[>--[>--[>--[]--[]--<>-X[
----xxx--[]--[]--x----xxX[]--xxx-<>-x[]--[]--[]--[]--[]--[]EX[]--[]--[]--[]XX[
-xxxx<>--[]--[]---xxxxxXX[]--<>X-[]--[]--XXXXXXXXXXEXXXXXXXXXXXXXXXXXXXXXXXXXX
XXXXX[]--XXXXXXXXXXXX<>XXXXXX[]XXXXXXXXXXXXXXXXXXXXXXXXXXXXXXXXXXXXXXXXXXXXXXX
