NNNNNNNNNNNNNNNNNNN
NNNNNNNNNNNNNNNNNNN
NNNNNYYNNYYNNYYNNYY
NNNNNNNNNNNNNNNNNNN
NNNNNNNNNNNNNNNNNNN
-------------------
-------------------
-------------------
-------------------
-------------------
-----------------xx
-----------------x-
----------------x<-
--------------xxx[]
--------xxx--xx--[]
-------xx--xxx---[]
------xx-E--x----[]
-----xx-----S----[]
----xx----E-SEE--[]
-xxxxEE---XXXXX--XX
XXXXXXX---XXXXX--XX
