NNNNNNNNNNNNNNNNNNN
NNNNNNNNNNNNNNNNNNN
NNNNNYYNNYYNNYYNNYY
NNNNNNNNNNNNNNNNNNN
NNNNNNNNNNNNNNNNNNN
-------------------
-------------------
-------------------
-------------------
-------------------
-------------------
-------------------
-------------------
-------------------
-------------------
------------------E
----------o------EX
-----EE--E---------
--------------E----
-xxxxxxxxxxxxxxxxxx
XXXXXXXXXXXXXEXXXXX
