NNNNNNNNNNNNNNNNNNN
NNNNNNNNNNNNNNNNNNN
NNNNNYYNNYYNNYYNNYY
NNNNNNNNNNNNNNNNNNN
NNNNNNNNNNNNNNNNNNN
-------------------
-------------------
-------------------
-------------------
-------------------
-------------------
-------------------
-------------------
---------xxxxxx----
--------xx---x-x---
-------xx-------x--
------xx---------xE
-----xx-----------x
----xx--------E----
-xxxxEE--EE--EE----
XXXXXXXXXXXXXXXX---
