NNNNNNNNNNNNNNNNNNN
NNNNNNNNNNNNNNNNNNN
NNNNNYYNNYYNNYYNNYY
NNNNNNNNNNNNNNNNNNN
NNNNNNNNNNNNNNNNNNN
-------------------
-------------------
-------------------
-------------------
-------------------
-------------------
------------------E
-------------E----x
--------xxxxx----xx
-------xx----x--xx-
------xx------xxx--
-----xx-------Ex-E-
----xx---------XX--
---xx--------------
-xxx-EE--EE--------
XXXXXXXXXXXXX------
