NNNNNNNNNNNNNNNNNNN
NNNNNNNNNNNNNNNNNNN
NNNNNYYNNYYNNYYNNYY
NNNNNNNNNNNNNNNNNNN
NNNNNNNNNNNNNNNNNNN
-------------------
-------------------
-------------------
-------------------
-------------------
-------------------
-------------------
------------------E
------------------X
-----------------E-
--------------E----
-------------E-----
----------E--------
-----E---E---------
-xxxxxxxxxxxxxxxxxx
XXXXX-XXXXXXXXXXXXX
