NNNNNNNNNNNNNNNNNNN
NNNNNNNNNNNNNNNNNNN
NNNNNYYNNYYNNYYNNYY
NNNNNNNNNNNNNNNNNNN
NNNNNNNNNNNNNNNNNNN
-------------------
-------------------
-------------------
-------------------
-------------------
-------------------
-------------------
-------------------
-------------------
-------------------
-------------------
----------E-------E
-----E---E-------E-
-----xxx-----EE----
-xxxxxE-xxxxxxxxxxx
XXXXXXXXXXXXXXXXXXX
