NNNNNNNNNNNNNNNNNNN
NNNNNNNNNNNNNNNNNNN
NNNNNYYNNYYNNYYNNYY
NNNNNNNNNNNNNNNNNNN
NNNNNNNNNNNNNNNNNNN
-------------------
-------------------
-------------------
-------------------
-------------------
-------------------
----------------SS-
------------------S
-------------------
---------------xxxx
--------------xx---
-----EE---E--xx----
---------E--xx-----
-----------xx-E----
-xxxxxxxxxxxXEX----
XXXXXXXXXXXXXXX---E
