NNNNNNNNNNNNNNNNNNN
NNNNNNNNNNNNNNNNNNN
NNNNNYYNNYYNNYYNNYY
NNNNNNNNNNNNNNNNNNN
NNNNNNNNNNNNNNNNNNN
-------------------
-------------------
-------------------
-------------------
-------------------
-------------------
-------------------
-------------------
-------------------
-------------------
-----EE---E--------
---------E--------o
---------E---E---E-
-------------xxx---
-xxxxxxxxxxxxxE-xxx
XXXXXXXXXXXXXXXXXXX
