NNNNNNNNNNNNNNNNNNN
NNNNNNNNNNNNNNNNNNN
NNNNNYYNNYYNNYYNNYY
NNNNNNNNNNNNNNNNNNN
NNNNNNNNNNNNNNNNNNN
-------------------
-------------------
-------------------
-------------------
-------------------
-------------------
-------------------
-------------------
------X------------
-----E-------------
--------------xxxxx
---------Eo--xx----
------E-----xx-----
-----------xx----E-
-xxxxxxxxxxx-E---XE
XXXXXXXXXXXX-----XX
