NNNNNNNNNNNNNNNNNNN
NNNNNNNNNNNNNNNNNNN
NNNNNYYNNYYNNYYNNYY
NNNNNNNNNNNNNNNNNNN
NNNNNNNNNNNNNNNNNNN
-------------------
-------------------
-------------------
-------------------
-------------------
-------------------
-------------------
-------------------
-------------------
--------------xxxxx
--------xxxxxxx----
-------xx----x-----
------xx-----------
-----xx------------
-xxxxxE---E--EE--EE
XXXXXEXXXXXXXXXXXXX
