NNNNNYYNNYYNNYYNNYY
NNNNNNNNNNNNNNNNNNN
NNNNNNNNNNNNNNNNNNN
NNNYYNNYYNNYYNNYYNN
NNNNNNNNNNNNNNNNNNN
-------------------
-------------------
-------------------
-------------------
-------------------
-------------------
-------------------
-----Q------------S
-------------------
---<E--------------
---[>------<-------
---X-QQ--Q?[>QQB-QQ
-----------[]--b---
-------E---X----B--
-xxxxxxxxxxxxxxxxxx
XXXXXXXX<XXXXXXXXXX
