NNNNNYYNNYYNNYYNNYY
NNNNNNNNNNNNNNNNNNN
NNNNNNNNNNNNNNNNNNN
NNNYYNNYYNNYYNNYYNN
NNNNNNNNNNNNNNNNNNN
-------------------
-------------------
-------------------
-------------------
-------------------
-------------------
-------------------
-------------------
---<---------------
---[---------------
---[>------<-------
---X>QQ--QQ[>QQ--?Q
-----------[]------
-------B---X]--<>--
-xxxxxxxxxxX]--[]--
XXXXXXXX<XXXXXXXXXX
