NNNNNYYNNYYNNYYNNYY
NNNNNNNNNNNNNNNNNNN
NNNNNNNNNNNNNNNNNNN
NNNYYNNYYNNYYNNYYNN
NNNNNNNNNNNNNNNNNNN
-------------------
-------------------
-------------------
-------------------
-------------------
-------------------
-------------------
-------------S---S-
-------------------
-------------------
-------------------
---<>QQ--QQ--??--QQ
-----------<-------
------------------x
-xxxxxxxxxxxxxxxxxx
XXXXXXX<>XXXXXX<>XX
