NNNNNYYNNYYNNYYNNYY
NNNNNNNNNNNNNNNNNNN
NNNNNNNNNNNNNNNNNNN
NNNYYNNYYNNYYNNYYNN
NNNNNNNNNNNNNNNNNNN
-------------------
-------------------
-------------------
-------------------
-------------------
-------------------
-------------------
---------?Q--------
-------------------
-------------?---?-
------?--xxx--?---?
-----?--xx--xx-----
--------x--<>-x--xx
----xxxx>--[]--xxx-
-xxxx--<]--XXXX<>--
XXX<>--[]--XXXX[]--
