NNNNNYYNNYYNNYYNNYY
NNNNNNNNNNNNNNNNNNN
NNNNNNNNNNNNNNNNNNN
NNNYYNNYYNNYYNNYYNN
NNNNNNNNNNNNNNNNNNN
-------------------
-------------------
-------------------
-------------------
-------------------
-------------------
-------------------
-----------------SS
-------------------
-------------------
-------------------
-----QQ--?Q--QQ-<QQ
-------B---B---B---
-------b---bB--b---
-xxxxxxxxxxxxxxxxxx
XXX<>XXXXXXXXXXXXXX
