NNNNNYYNNYYNNYYNNYY
NNNNNNNNNNNNNNNNNNN
NNNNNNNNNNNNNNNNNNN
NNNYYNNYYNNYYNNYYNN
NNNNNNNNNNNNNNNNNNN
-------------------
-------------------
-------------------
-------------------
-------------------
-------------------
-------------QQ--?Q
----------xxxx---?-
----------x<>-x----
---------x-[]--xxxx
-----?xx-x-[]---x--
-----x?-xx?[]--<>--
----xx--<>-[]--[]--
---xx---[]-[]--[]--
-xxx>--E[]-[]--[]--
XXX<]-XXX]-XXXXXX--
