NNNNNYYNNYYNNYYNNYY
NNNNNNNNNNNNNNNNNNN
NNNNNNNNNNNNNNNNNNN
NNNYYNNYYNNYYNNYYNN
NNNNNNNNNNNNNNNNNNN
-------------------
-------------------
-------------------
-------------------
-------------------
-------------------
-------------------
-----QQ-----SSSSSS?
-------------------
-------------------
-------------------
-----QQ--QQE<QQEE?S
---<E------E<--SS--
-------------------
-xxxxxxxxxxxxxxxxxx
XXXXXXXX<XXXXXXXXXX
