NNNNNYYNNYYNNYYNNYY
NNNNNNNNNNNNNNNNNNN
NNNNNNNNNNNNNNNNNNN
NNNYYNNYYNNYYNNYYNN
NNNNNNNNNNNNNNNNNNN
-------------------
-------------------
-------------------
-------------------
-------------------
-------------------
---------Q-----S---
-----QQSS-SSS-?-SSS
-------------------
-------------------
---------S?-E---E--
-----?SEE--SS?SSS?Q
----B--------------
---Bxxxxxxxx-------
-xxxx-------xxxxxxx
XXXXX-------XXXXXXX
