NNNNNYYNNYYNNYYNNYY
NNNNNNNNNNNNNNNNNNN
NNNNNNNNNNNNNNNNNNN
NNNYYNNYYNNYYNNYYNN
NNNNNNNNNNNNNNNNNNN
-------------------
-------------------
-------------------
-------------------
-------------------
-------------------
-------X-----------
------QX-----------
-------X-----------
-------X-------<---
-------X-------[>--
-----?QX-QQ--QQ[]QQ
---------------[]--
-------E-----------
-xxxxxxxxxxxxxxxxxx
XXX<>XXX<XX<>XXXXXX
