NNNNNYYNNYYNNYYNNYY
NNNNNNNNNNNNNNNNNNN
NNNNNNNNNNNNNNNNNNN
NNNYYNNYYNNYYNNYYNN
NNNNNNNNNNNNNNNNNNN
-------------------
-------------------
-------------------
-------------------
-------------------
-------------------
-------------------
-----------------?Q
-------------------
---------?---------
---<>------------x-
---[]QQ<>-Q--?Q---x
---[]--[]------->-S
---[]--[]--<>--<]--
-xx[]--[]--[]--[]--
XXXXXXXXXXXXX--XXX-
